自身免疫性胃炎	胃炎
沸水烫伤未愈肉芽创面21％躯干双下肢左?	沸水烫伤##躯干部烫伤##下肢烫伤
滑膜炎左膝滑膜皱襞综合症	滑膜炎##膝关节滑膜皱襞综合征
右侧基底节多发陈旧性腔隙行梗塞	基底节脑梗死##腔隙性脑梗死##多发性脑梗死##陈旧性脑梗死
背部皮肤擦伤	躯干浅表擦伤
右上肺周围型中分化肺癌IIIa	右肺上叶恶性肿瘤##癌
2左额颞顶部颅骨缺损右颞右枕骨折	颅骨骨折
免疫性血小板减少症伴失血性贫血	免疫性血小板减少##失血性贫血
右肾及输尿管结石	肾输尿管结石
右肱骨外髁骨折神经损伤	肱骨外髁骨折##上肢神经损伤
大汗腺炎	未特指的顶(浆分)泌汗腺疾患
掌指角皮病复诊取药	角化病
原发性高压3级	原发性高血压##高血压3级
左侧肢体活动不灵伴意识不清原因待查	意识障碍
"失眠,静脉曲张,行动不便"	失眠##静脉曲张
右肾盂输尿管占位	肾占位性病变##输尿管占位性病变
双鼻腔新生物送检为霉菌倾向曲菌	鼻腔息肉##曲霉菌病
活检组织显示B淋巴细胞高度增生	淋巴细胞增殖性疾病
甲状腺乳头状癌二次术后复发	甲状腺恶性肿瘤##甲状腺术后##甲状腺乳头状癌##恶性肿瘤复发
右腮腺肿物	唾液腺肿物
腰5椎体横突撕脱性骨折	腰椎骨折L5
结节型S7结节型剖宫产后	无指征剖宫产的单胎分娩
颈椎硬膜外血肿并截瘫	未特指的截瘫##硬脊膜外血肿
"左足底黑色素瘤扩大切除术后,左下肢肌肉间转移，肺、肝转移？,胃溃疡"	足部恶性肿瘤##恶性黑色素瘤##下肢继发恶性肿瘤##肺继发恶性肿瘤##肝继发恶性肿瘤##胃溃疡##转移性恶性黑色素瘤
前列腺癌；糖尿病；高血压	前列腺恶性肿瘤##癌##糖尿病##高血压
急性非ST段抬高型心肌梗塞PCI至RCA	冠状动脉支架植入术后状态##急性非ST段抬高型心肌梗死
双耳极重度感音性聋	双侧感音神经性聋
腹泻病急性轻型3卵圆孔未闭	卵圆孔未闭
两侧基底节腔隙性梗塞	腔隙性脑梗死##基底节脑梗死
"横结肠癌 肠道出血 缺铁性贫血,叶酸缺乏,乙型肝炎"	横结肠恶性肿瘤##肠出血##缺铁性贫血##叶酸缺乏##O##癌
淋巴细胞减少症	淋巴细胞减少
双眼真性小眼球	真性小眼球
右侧胸腔积血并积气	血气胸
带状疱疹性神经痛	带状疱疹后神经痛
主动脉中度关闭不全伴轻度狭窄	动脉狭窄##主动脉瓣关闭不全
自身免疫性疾病不除外	自身免疫病
骶前神经鞘瘤术后	神经鞘瘤##骶前良性肿瘤
夜尿多待查	尿频
1.腹痛待查2.多动待查	腹痛##注意缺陷与多动障碍
右膝外侧盘状半月板内侧间室OA	先天性盘状半月板##单侧膝关节骨性关节病
网状类牛皮癣	网状副银屑病
重度听力损害	听功能障碍
继发性血红蛋白增多症	血红蛋白增高
发作性感觉异常右上肢肌力减退	肌无力
右肩枪伤	肩部开放性损伤##枪击伤
右小腿皮肤软组织损伤	"下肢未特指的损伤,水平未特指"
2型退变并周围神经病变	多发性神经病[多发性神经炎/周围神经炎]
降结肠1管状腺瘤降结肠2早期管状腺瘤	管状腺瘤##降结肠良性肿瘤
停经285周41单胎高龄妊娠胎儿NT增厚	妊娠状态
右肺鳞癌中医治疗	右肺恶性肿瘤##鳞状细胞癌##恶性肿瘤中医治疗
胃窦幽门前区异位胰腺内镜粘膜下剥离术	胃内异位胰腺
腰椎陈旧性压缩性骨折	腰椎压缩性骨折##陈旧性腰椎骨折
植物神经紊乱躯体化功能障碍	植物神经功能紊乱##躯体化障碍
左肺上叶肺大泡破裂并气胸左侧胸壁引流术后	肺大疱破裂##气胸##胸腔闭式引流术后
右侧额颞顶部慢性硬膜下血肿并急性出血	颅内出血
热水烫伤躯干右股TBSA7%深Ⅱ度	下肢烫伤
右乳腺增生病伴囊肿形成并见异物肉芽肿	乳腺增生##乳腺囊肿##异物肉芽肿
盘状红斑狼疮	盘状狼疮
右侧胸膜增厚伴钙化	胸膜钙化##胸膜肥厚
细菌性阴道炎(外阴炎)	细菌性阴道炎##外阴炎
结缔组织相关性间质性肺病	结缔组织病##间质性肺病
周围型肺癌可能大	肺恶性肿瘤##癌
双肺病灶性质待查炎性可能性大恶性不除外	肺炎##双肺恶性肿瘤
子宫颈上皮瘤样病变CINI级	子宫颈上皮瘤样病变[CIN]I级
右肺癌IIIA期	右肺恶性肿瘤##癌
前列腺癌骨髓侵犯	前列腺恶性肿瘤##骨髓继发恶性肿瘤##癌
血尿蛋白尿查因:IGA肾病	血尿##蛋白尿##IgA肾病
头颈部皮下肿物	头部肿物##颈部肿物
语言发育差查因	言语和语言发育障碍
右胫骨中下段骨质破坏骨纤维结构不良症	骨质破坏##胫骨纤维结构不良
颅脑创伤后意识障碍	头部损伤##意识障碍
脑底异常血管网病云雾病	烟雾病[脑底异常血管网病]
肩背冷痛月经先期	背痛##肩痛
心慌、震颤	震颤##心悸
糖尿病，非胰岛素依赖型(Ⅱ)；恶性肿瘤并全身多器官转移	2型糖尿病##广泛转移性肿瘤
绝经后期子宫内膜分泌期改变	绝经期
节育环膀胱异位	避孕环移位
脑底血管异常网病	烟雾病[脑底异常血管网病]
右手示指指尖缺如	手指损伤
左股骨骨折术后	股骨骨折##骨折术后
胃角异位胰腺内镜下剥离术ESD后	胃内异位胰腺
左足第2趾远节趾骨骨折，左足第2趾软组织缺损	足部损伤##趾骨骨折
左胫骨中下段骨折术后	胫骨骨折##骨折术后
原发中枢系统淋巴瘤	淋巴瘤
急性移植物抗宿主反应病I度皮肤胃肠道肝脏	急性移植物抗宿主病
陈旧性会阴3度撕裂阴道前后壁膨出2度	陈旧性会阴裂伤##阴道前后壁脱垂
面颈部皮肤松弛	面部皮肤松弛##颈部皮肤松弛
颈椎病；胸背肌筋膜炎	颈椎病##筋膜炎
右乳导管内乳头状瘤切除术术后	导管内乳头状瘤##乳腺术后##乳腺良性肿瘤
右踝关节骨裂	踝关节骨折
子宫内膜癌 慢支 化疗中	子宫内膜恶性肿瘤##慢性支气管炎##化学治疗##癌
"肺癌抗过敏,肝转移？"	肺恶性肿瘤##癌##肝继发恶性肿瘤##转移性癌
冠状动脉粥样症前降支心肌桥	冠状动脉粥样硬化##冠状动脉肌桥
发疹性皮肤病	皮疹
糖尿病高血压高血脂症	糖尿病##高血压##高脂血症
卵巢癌化疗后	卵巢恶性肿瘤##癌##化学治疗
6化疗后肝功能轻度异常	化学治疗##肝功能异常
肛周尖锐湿疣	肛门周围尖锐湿疣
肺功能减退声门裂狭窄	声门狭窄##肺功能异常
"非霍奇金淋巴瘤,上腔静脉压迫综合征,化疗期间,肝功能损害,白细胞减少,静脉血栓形成,上呼吸道感染，咳嗽"	非霍奇金淋巴瘤##O##化学治疗##肝功能不全##白细胞减少##静脉血栓形成##上呼吸道感染##咳嗽
G2P0孕34+5周宫内妊娠L	孕34周
胼胝体膝部发育不良	胼胝体发育不全
躯体神经官能症	其他特指的神经症性障碍
1.主动脉夹层.2.哮喘	主动脉夹层形成##支气管哮喘
甲状腺滤泡性癌	甲状腺恶性肿瘤##滤泡性癌
肝外胆管扩张	胆管扩张
泌尿系统疾病高PSA血症	PSA升高##泌尿系统未特指的疾患
肝癌伴肝内转移	肝恶性肿瘤##癌##肝继发恶性肿瘤##转移性癌
盆腔多发转移	盆腔继发恶性肿瘤##转移性肿瘤
左内踝玻璃割伤	踝部开放性损伤##玻璃割伤
急性移植物抗宿主反应肝脏I度	急性移植物抗宿主病
阑尾扩张肠管退变坏死	阑尾未特指的疾病##肠坏死
皮肤鳞状细胞癌术后	皮肤恶性肿瘤##鳞状细胞癌
"上呼吸道感染、发热、咳嗽咳痰,咽痛、牙痛,行动不便,过敏性鼻炎"	上呼吸道感染##发热##咳嗽##咽痛##牙痛##过敏性鼻炎[变应性鼻炎]
移位甲状腺	甲状腺异位
创伤性硬膜下积液	硬膜下积液
左小腿截肢残端肌肉及皮肤软组织坏死	截肢
缺锌重轻度缺铁胃口睡眠差	食欲不振##铁缺乏##锌缺乏##睡眠障碍
骶骨神经纤维瘤	神经纤维瘤病[VonRecklinghausen病]
双侧股骨头置换术后	人工关节术后
右膝关节外侧不完全盘状半月板撕裂	先天性盘状半月板##膝外侧半月板撕裂
子宫增大见节育器影	具有子宫内避孕装置
右顶部良性脑膜瘤	脑膜瘤
重度疼痛胰腺癌	前列腺恶性肿瘤##癌##癌性疼痛
右甲良性病变术后	未特指的甲状腺疾患##甲状腺术后
循环系统操作后疾患房缺修补冠脉搭桥	房间隔缺损修补术后##冠状动脉搭桥术后
炎症后色素减退.足癣	足癣
舌腹血管畸形	舌血管畸形
腹痛待查、原发性高血压2级高危	腹痛##原发性高血压##O
"直肠癌术后ypT2N0M0,高血压,冠心病,双肾囊肿"	直肠术后##直肠恶性肿瘤##高血压##冠状动脉粥样硬化性心脏病##癌##肾囊肿
双侧听力重度损害	听功能障碍
右足及小腿缺血性坏死有腘窝皮坏死	下肢皮肤坏死##足坏死
膀胱肿瘤低度恶性潜能	膀胱恶性肿瘤
颅底凹陷症伴不全瘫	先天性颅底凹陷症##不完全性瘫痪
精神运动发育迟缓遗传代谢性病	未特指的精神发育迟缓
皮肤病其他	皮肤和皮下组织其他特指的疾患
CAD，肾衰	冠状动脉粥样硬化性心脏病##肾衰竭
右顶枕动静脉畸形	脑动静脉畸形
双眼外隐斜	外隐斜
胸5-6脂肪瘤	脂肪瘤##脂肪瘤
1.子宫腺肌病。增生期子宫内膜。子宫内膜息肉	子宫肌腺症##子宫内膜息肉
退行性瓣膜病二尖瓣三尖瓣主动脉瓣?	二尖瓣退行性变##三尖瓣病##退行性主动脉瓣疾患
双膝外侧盘状半月板	先天性盘状半月板
反复发作低血糖	低血糖症
左输卵管异位妊娠	输卵管妊娠
腰椎间盘突出(腿麻)	腰椎间盘突出
宫颈乳头状鳞形细胞癌放疗后	子宫颈恶性肿瘤##乳头状鳞状细胞癌##恶性肿瘤放疗
功血子宫肌瘤	子宫不规则出血##子宫平滑肌瘤
左膝关节软组织挫伤	膝部挫伤
心律失常窦性心动过速	窦性心动过速
脾肉芽肿性炎	肉芽肿
急性心梗继发心衰	急性心肌梗死##急性心力衰竭
左下肺CA	左肺下叶恶性肿瘤##癌
腰椎双膝骨关节病行动不便肌肉关节痛颈椎病	膝骨关节病##肌痛##关节痛##颈椎病##腰椎病
长期胃口差间歇性清晨眼睑浮肿	眼睑水肿##食欲不振
颈椎骨折伴截瘫	颈椎骨折##高位截瘫
高总胆固醇血症高低密度脂蛋白胆固醇血症	高脂血症##血脂异常
宫内环下移	避孕环移位
左股骨慢性骨髓炎	股骨骨髓炎##慢性骨髓炎
胸部枪击伤	胸部开放性损伤##枪击伤
升结肠中分化腺癌，部分为粘液腺癌（pT4aN1M0，3B期，高危）术后第一次化疗	升结肠恶性肿瘤##腺癌##粘液腺癌##恶性肿瘤术后化疗
表皮肥厚伴灶性棘层肥厚	其他表皮肥厚
胸骨后不适待查，NERD待排	胃食管反流
缺铁;卵圆孔未闭	铁缺乏##卵圆孔未闭
全身多处骨发育不良	未特指的骨软骨发育不良
全身多发神经纤维瘤病	神经纤维瘤病[VonRecklinghausen病]
直肠乙状结肠交界腺癌	直肠乙状结肠连接部恶性肿瘤##腺癌
1颏下疤痕伴色素沉着	色素沉着未特指的疾患##面部瘢痕
左踝关节损伤	踝关节扭伤
右肺小细胞癌ED期	右肺恶性肿瘤##小细胞癌
子宫颈中分化鳞癌IIb期放射治疗	子宫颈恶性肿瘤##鳞状细胞癌
双肘腕软组织劳损	腕部劳损##肘部劳损
肝脏粘液性囊性肿瘤	肝良性肿瘤##粘液性囊瘤
回盲部肠管坏死并破裂	肠坏死##肠破裂
宫颈原位鳞状细胞癌	子宫颈原位癌##鳞状细胞癌
腹腔非霍奇金淋巴瘤	腹部恶性肿瘤##非霍奇金淋巴瘤
烧伤后全身瘢痕增生	多处烧伤##全身多处瘢痕
L1L2椎体骨质破坏伴L1椎体压缩性改变	骨质破坏##腰椎压缩性骨折##腰椎骨折L1
低锌低铁地贫	铁缺乏##锌缺乏##地中海贫血
左手左足机器割伤	手部开放性损伤##足部开放性损伤
右手指麻木待查高血脂	高脂血症
胆管囊肿切除术后	胆管囊肿##胆道术后
右股骨内髁SONK右膝中度OA	骨坏死##单侧膝关节骨性关节病
脑多发缺血梗塞灶双侧脑室旁半卵圆中心?	多发性脑梗死
恶性肿瘤静脉输注化疗药物	化学治疗
脑室少许缺血脱髓鞘改变	脱髓鞘性脑病##脑血管供血不足
走路差待查小脑发育欠佳	先天性脑发育不全
外阴交搭跨越恶性肿瘤	外阴交搭跨越恶性肿瘤的损害
西医1后循环缺血2左侧椎动脉发育变异	后循环缺血
卵巢恶性肿瘤伴腹水	卵巢恶性肿瘤##腹水
CABG术后胸腔积水	冠状动脉搭桥术后##胸腔积液
原发性高血压Ⅱ级	原发性高血压##高血压2级
颈部劳损	颈部其他和未特指部位关节和韧带扭伤和劳损
乳腺分叶状肿瘤	叶状瘤
"胃印戒细胞癌 局部进展期,肺癌术后 免疫力低 过敏性皮炎,上呼吸道感染 发热 咳嗽"	胃恶性肿瘤##印戒细胞癌##肺术后##肺恶性肿瘤##癌##过敏性皮炎##上呼吸道感染##发热##咳嗽
高血压慢性肾病	高血压性肾病
颊粘膜裂伤	口腔粘膜开放性损伤
1型糖尿病性胃肠神经病变胃轻瘫	1型糖尿病##糖尿病性胃轻瘫
神经型布氏杆菌病吉兰巴雷综合征可能性大	吉兰-巴雷综合征
脊膜脊髓膨出	脊髓脊膜膨出
腰椎骨折伴截瘫	腰椎骨折##截瘫[双下肢瘫痪]
右肾结石伴肾积水	肾积水伴肾结石
右小腿及踝部软组织伤	"下肢未特指的损伤,水平未特指"
角膜cashang	角膜擦伤
支气管扩张，胃肠炎	支气管扩张症##胃肠炎
横结肠结肠粘膜低级别管状腺瘤粟粒大1块	横结肠良性肿瘤##管状腺瘤
右肺癌伴肺内转移 肝内转移 骨转移	右肺恶性肿瘤##癌##肺继发恶性肿瘤##肝继发恶性肿瘤##骨继发恶性肿瘤##转移性癌
胸椎陈旧性压缩性骨折	胸椎压缩性骨折##陈旧性胸椎骨折
急性T淋巴细胞白血病L3型（中危，完全缓解期）	急性淋巴细胞白血病L3
卵巢囊肿术后	卵巢囊肿##卵巢术后
双眼白内障术后	白内障##眼术后
回肠系膜高侵袭性B细胞源性非霍奇金淋巴瘤II期（Burrkitt淋巴瘤）化疗后	非霍奇金淋巴瘤(B细胞型)
远近端造瘘口肠管可见神经节细胞	未特指的人工造口状态
右下腹肌肉慢性炎	肌炎
冠心病-心功能IV级	冠状动脉粥样硬化性心脏病##心功能IV级(NYHA分级)
右足背玻璃割伤	足部开放性损伤##玻璃割伤
胎儿死亡	胎死宫内
子宫癌肉瘤II期	子宫恶性肿瘤##癌肉瘤
右肺下叶中分化鳞状细胞癌	右肺下叶恶性肿瘤##鳞状细胞癌
肾积水伴肾和输尿管结石(术后)	肾积水##肾输尿管结石##肾术后##输尿管术后
巨大胎儿	巨大儿
胆囊绒毛管状腺瘤伴灶性重度异型增生?	管状绒毛状腺瘤##胆囊良性肿瘤##胆囊不典型增生
上下前牙唇倾牙列拥挤正畸牙拔除术	牙齿拥挤##牙外科正畸术后
乙状结肠管状腺瘤Ⅰ级切缘为查见病变	管状腺瘤##乙状结肠良性肿瘤
原发中枢神经系统淋巴瘤放化疗后	淋巴瘤##恶性肿瘤放疗##化学治疗
双下肺炎并右侧胸腔积液	胸腔积液
右上肺小细胞癌	右肺上叶恶性肿瘤##小细胞癌
双下肢右足拇指电灼伤	"电流引起烧伤##足趾损伤##下肢未特指的损伤,水平未特指"
左侧肾上腺占位伴高血压	高血压##肾上腺占位
双卵巢中低分化子宫内膜样腺癌	卵巢恶性肿瘤##子宫内膜样腺癌
双侧输卵管高级别浆液性癌IIIC期	浆液性癌##输卵管恶性肿瘤
原发性支气管肺癌(左肺小细胞肺癌cT2bN2M0　局限期　PS0分)	左肺恶性肿瘤##小细胞癌
肝胆管粘液腺癌	肝胆管恶性肿瘤##粘液腺癌
粘膜下平滑肌瘤	平滑肌瘤
右耳蜂蜇伤	蜂螫伤##耳部损伤
新生儿面部挤压综合征	新生儿挤压综合征
脑缺血改变老年性脑改变	脑血管供血不足
5.头部外伤：1）轻型颅脑损伤	创伤性脑损伤##头部损伤
鼻咽横纹肌肉瘤	鼻咽恶性肿瘤##横纹肌肉瘤
多发性脑缺血脑髓鞘病	脱髓鞘性脑病##脑血管供血不足
右手中指远节完全离断	单指完全离断
左前臂骨筋膜综合症	上肢骨筋膜室综合征
支气管哮喘并肺部感染	支气管哮喘##肺部感染
停经292周B超提示胎儿左侧颈部无回声区	妊娠状态
左拇指指腹皮肤缺失	皮肤缺损
右小腿软组织撕脱并缺损	小腿撕脱伤
升结肠癌，pT2N0；	升结肠恶性肿瘤##癌
阴道和外阴特指炎症	外阴炎##阴道炎
外源性色素色汗症	色汗症
左膝关节滑膜炎	膝关节滑膜炎
1型糖尿病伴有多个并发症	1型糖尿病伴多个并发症
缺铁缺锌铅较高腹部淋巴肿大	铁缺乏##锌缺乏##铅中毒##淋巴结肿大
急性肺梗塞	肺梗死
慢性肺曲霉病急性发作	肺曲霉菌病
停经待查早孕宫外孕右侧卵巢旁囊性回声	妊娠状态##异位妊娠##停经
胰后脾静脉海绵样变	海绵状血管瘤
慢性鼻窦炎伴息肉	慢性鼻窦炎##鼻息肉
绝经后双乳增生	绝经期##乳腺增生
右肾结节查因:错构瘤	肾错构瘤##肾占位性病变
骶尾骨痛	尾骨痛
右膝外侧半月板体部Ⅲ°放射裂后角Ⅲ°水	膝外侧半月板撕裂
肝癌射频消融治疗后	肝恶性肿瘤##癌##射频消融术后
急性化脓性胆管炎伴胆总管结石	胆总管结石伴急性化脓性胆管炎
糖尿病性神经病变(待查)	糖尿病伴神经系统并发症
多发性脑梗死灶后遗症期	多发性脑梗死##脑梗死后遗症
（鼻咽）低分化鳞状细胞癌	鼻咽恶性肿瘤##鳞状细胞癌
皮炎(面部皮炎伴感染)	皮炎##感染
贲门胃体管状腺瘤	管状腺瘤##贲门良性肿瘤##胃良性肿瘤
41楔状缺损3646磨损	牙齿楔状缺损##牙齿磨损
右手小指外伤清创术后	手指开放性损伤##清创术后
胃窦异位胰腺	胃内异位胰腺
右肾积水伴右输尿管扩张	肾积水##输尿管扩张
"右上肺中央型腺鳞癌（pT2N2M0, IIIa期）术后伴右肺、右胸壁、肋骨多发转"	肺术后##右肺上叶恶性肿瘤##鳞状细胞癌##肺继发恶性肿瘤##胸壁继发恶性肿瘤##肋骨继发恶性肿瘤##转移性癌
肢体擦伤伴异物	开放性损伤伴异物
侵入性肺曲霉病治疗后	肺曲霉菌病
从2米高房屋上摔下致伤	自高处坠落
重症多型红斑	重症型多形红斑
颈椎骨质破坏原因待查	骨质破坏
右下肺腺癌多发脑转移 EGFR19号外显子缺失	右肺下叶恶性肿瘤##脑继发恶性肿瘤##腺癌##转移性腺癌
抗病毒治疗高指血症	高脂血症
2型糖尿病合并2型糖尿病性周围神经病变	2型糖尿病##2型糖尿病性周围神经病
静脉发育不良下肢	周围动静脉畸形
特指手术后状态(左下肢浅静脉术后)	其他特指的手术后状态
右乳中分化浸润性导管癌	乳腺恶性肿瘤##浸润性导管癌
双眼上睑睑缘炎	睑缘炎
CAA肺部感染	淀粉样脑血管病##肺部感染
CHDHF	冠状动脉粥样硬化性心脏病##心力衰竭
言语错乱	言语障碍
先天性双侧髋关节错位	先天性髋关节脱位
左腰部纤维脂肪瘤术后复发	腰部良性肿瘤##纤维脂肪瘤
周围动脉粥样硬化症(颈动脉)	颈动脉硬化##外周动脉粥样硬化
"行动不便,SLE，,上呼吸道感染、发热、咳嗽咳痰,咽痛,慢性便秘,高脂血症,高血压,预防血栓,肝肾阴虚、腰膝酸软"	系统性红斑狼疮##上呼吸道感染##发热##咳嗽##咽痛##便秘##高脂血症##高血压
鞍区占位伽马刀治疗后	颅内占位性病变##放射治疗
脂肪脊髓脊膜膨出	脊髓脊膜膨出
左眼视网膜毛细血管前小动脉阻塞	其他视网膜动脉阻塞
颈部粥样斑块硬化症	颈动脉粥样硬化
心肌桥左室舒张功能减低	冠状动脉肌桥
童年孤独症	儿童孤独症
特指手术后状态(乳腺)	乳腺术后##其他特指的手术后状态
右上肢躯干开水烫伤	沸水烫伤##躯干部烫伤##上肢烫伤
G周妊娠分娩LOA	正常分娩
可疑恶性肿瘤观察高CEACa19-9血症	可疑恶性肿瘤的观察##CA199升高
右肾透明细胞癌右肾肿瘤	肾恶性肿瘤##透明细胞癌
组织细胞郎罕细胞增多症	朗格汉斯细胞组织细胞增生症
电解质紊乱-低钠钾氯血症	电解质紊乱##低钠血症##低钾血症##低氯血症
乙状结肠造口状态	结肠造口状态
右膝部软组织损伤	"下肢未特指的损伤,水平未特指"
左锁骨下动脉及左椎动脉支架置入术	血管支架植入术后状态
耳廓纤维溜病	纤维瘤病
双肺多发网格影考虑间质改变可能性大	肺部阴影
左手掌皮肤软组织压轧伤	手部挤压伤
烧伤后颈部瘢痕挛缩畸形	颈部烧伤##颈部瘢痕##瘢痕挛缩
左室向心性肥厚左室舒张功能减低	心室肥厚
神志模糊右肢无力待查	肢体无力##意识障碍
右腕背玻璃割伤	腕部开放性损伤##玻璃割伤
骶管小囊肿	椎管内囊肿
双下肢肢端肥大	肢端肥大症
不育待查严重弱精子症	男性不育症##男方弱精症
右侧乳房肿块分叶状肿瘤	叶状瘤
"阴道炎,要求取环,月经不调,痛经,子宫腺肌症,盆腔炎"	阴道炎##月经紊乱##痛经##子宫肌腺症##女性盆腔炎
风湿性疾病伴肺部侵犯	风湿病
左肘疤痕挛缩伴功能受限	瘢痕挛缩##肘部瘢痕
玻粒体混浊眼底血管阻塞	玻璃体混浊
左下肢周围神经病变	多发性神经病[多发性神经炎/周围神经炎]
"左肾盂癌根治术后 IV期,膀胱转移根治术后,右输尿管皮肤造口术,盆腔局部复发,左侧髂外血管旁、左侧腹股沟区淋巴结转移,放疗,疼痛"	肾盂恶性肿瘤##膀胱继发恶性肿瘤##膀胱术后##输尿管造口状态##盆腔恶性肿瘤##腹股沟淋巴结继发恶性肿瘤##恶性肿瘤放疗##疼痛##髂淋巴结继发恶性肿瘤##癌##转移性癌
右颊粘膜舌覆扁平苔藓免疫异常	口腔扁平苔癣##舌扁平苔癣
上呼吸道感染mp感染	上呼吸道感染##支原体感染
右额颞创伤性硬膜下血肿	创伤性硬脑膜下血肿
术后伴胸壁、纵隔、腹膜后等多发淋巴结转移（T1bN3M1a IV期）	胸壁淋巴结继发恶性肿瘤##纵隔淋巴结继发恶性肿瘤##腹膜后淋巴结继发恶性肿瘤
下肢浅静脉曲张术后	下肢静脉曲张##静脉曲张术后
尿频伴肉眼血尿半天	尿频##血尿
颅内多发囊虫1纵裂池囊虫	未特指的囊虫病
"原发性高血压病(药物控制后,极高危)"	原发性高血压
闭塞性动脉粥样硬化症	闭塞性动脉硬化
肉芽肿性血管炎	韦格纳肉芽肿病[WegenersGranulomatosis病]
慢性移植物抗宿主反应病口腔皮肤眼	慢性移植物抗宿主病
右肾透明细胞癌T1N0M0	肾恶性肿瘤##透明细胞癌
中耳炎(伴急性结膜炎)	中耳炎##急性结膜炎
一侧肾萎缩	肾萎缩
脊髓灰质炎<脊髓型>	急性脊髓灰质炎
宫内妊娠	妊娠状态
L4-5腰椎间盘突出症、双膝骨关节炎	腰椎间盘突出##膝骨关节病
子宫颈上皮内病变III级	子宫颈上皮内瘤变III级[CINIII级]
左腘窝肌腱劳损	身体未特指部位的脱位、扭伤和劳损
纵隔肿瘤放疗	纵隔恶性肿瘤##恶性肿瘤放疗
L2腰椎陈旧性骨折	陈旧性腰椎骨折##腰椎骨折L2
小脑脑出血	小脑出血
甲状腺右叶乳头状微癌	甲状腺恶性肿瘤##乳头状微小癌
结肠绒毛状管状腺瘤低级别直径15cm	结肠良性肿瘤##管状绒毛状腺瘤
右眼虹膜缺如	先天性无虹膜
1.冠心病缺血性心肌病型心功Ⅲ-Ⅳ级	冠状动脉粥样硬化性心脏病##缺血性心肌病##心功能III级(NYHA分级)##心功能IV级(NYHA分级)
腰背劳损	腰部劳损##背部劳损
右肺继发恶性肿瘤	肺继发恶性肿瘤
盆腔包块待查：1）卵巢囊肿？2）卵巢肿瘤？3)炎性包块？	盆腔肿物##卵巢囊肿
颈动脉粥样硬化症	颈动脉粥样硬化
下颌骨发育不全	先天下颌骨颜面发育不全
癫痫或癫痫综合征	癫痫
糖尿病冠心病咽喉痛	糖尿病##冠状动脉粥样硬化性心脏病
截瘫康复期外伤后	未特指的截瘫##治疗后恢复期
前列腺癌？骨转移？	前列腺恶性肿瘤##癌##骨继发恶性肿瘤##转移性癌
滤泡癌	滤泡性癌
脑A硬化消化障碍	动脉硬化
急性移植物抗宿主反应病II度肠道	急性移植物抗宿主病
双侧腹股沟斜疝并隐睾	双侧腹股沟斜疝##隐睾
食管下段小细胞癌维持性化学治疗	食管下三分之一的恶性肿瘤##恶性肿瘤维持性化学治疗##癌
右肺下叶腺癌IVA期	右肺下叶恶性肿瘤##腺癌
眼周外伤	眼和眶未特指的损伤
右臀部皮脂腺囊肿感染	皮脂腺囊肿##感染
局限性皮肤萎缩	皮肤未特指的萎缩性疾患
胃食管结合部癌综合治疗后吻合口复发	食管胃连接部恶性肿瘤##癌##恶性肿瘤复发
送检右侧髋臼为死骨纤维组织伴坏死渗	骨坏死
"结肠癌,右肺上叶小结节"	结肠恶性肿瘤##肺占位性病变##癌
下咽占位	口腔和咽喉部占位
双侧视神经发育不全	视神经发育不良
卵巢Ca	卵巢恶性肿瘤##癌
慢性结石性胆囊炎急性发作	慢性胆囊炎急性发作
血吸虫性肝硬变	血吸虫性肝硬化
低锌肛周裂口	锌缺乏##肛裂
新生儿狼疮综合症	新生儿狼疮综合征
抽动－多动综合征	抽动秽语综合征
左足撕裂伤，左大腿挫裂伤	足部损伤##下肢撕裂伤##大腿损伤
急性脑梗塞左侧颞叶梗塞可能性大	脑梗死
中耳胆脂瘤(术后)	耳术后##中耳胆脂瘤
颅内多发缺血性脱髓鞘病变	脱髓鞘病
消化道其他部分后天性缺失	后天性消化道部分缺失
"宫颈癌 肠镜检查 肠道准备 肠镜麻醉,焦虑抑郁状态伴失眠，神经痛"	子宫颈恶性肿瘤##焦虑状态##抑郁状态##失眠##神经痛##癌
妊娠合并内科疾病	妊娠状态
面部发育畸形	先天性颅面发育不全
右耳中重度听力损失左耳极重度听力损失	未特指的听觉丧失
躯体化障碍外伤后神经症反应	躯体化障碍
开放性颅颌面内异物	面部异物
卵巢交界瘤(术后复查)	卵巢交界性肿瘤##卵巢术后
双胎之一左心室强光点	双胎妊娠
脐尿管瘘并感染	先天性脐尿管瘘##感染
肝癌术后; 低蛋白血症; 肝硬化	肝术后##肝恶性肿瘤##低蛋白血症##肝硬化##癌
左上肢背部玻璃割伤	上肢开放性损伤##背部开放性损伤##玻璃割伤
椎动脉供血不足	椎-基底动脉供血不全
左颌下淋巴结炎；咽扁炎；	颌下淋巴结炎
子宫颈低分化腺癌	子宫颈恶性肿瘤##腺癌
右手腕针刺伤	腕和手未特指的损伤
低色素小细胞性贫血重度	低色素性小细胞性贫血##重度贫血
下腹瘢痕痛	腹部瘢痕##疼痛
全身强直型发作	癫痫大发作[全身强直-阵挛性发作]
右手无力待查	肌无力
结膜炎，准分子术后ou	结膜炎
慢性阻塞性心脏病失代偿期	未特指的心脏病
"多发性骨髓瘤(KAPPA轻链型),D-S分期IIB期,ISS分期III期"	多发性骨髓瘤(轻链к型)##多发性骨髓瘤(ISS分期III期)##多发性骨髓瘤(DS分期II期B组)
急性阑尾炎穿孔伴腹膜炎	急性阑尾炎伴穿孔##急性阑尾炎伴腹膜炎
输尿管结石切开取石术后	输尿管结石##输尿管术后
"肝功能升高，化疗保肝,T淋巴母细胞淋巴瘤,"	肝功能异常##化学治疗##T淋巴母细胞白血病/淋巴瘤
前臂骨间背神经卡压症	骨间背侧神经卡压综合征
胸骨及左侧1-4肋骨折	肋骨多发性骨折伴第一肋骨骨折##胸骨骨折
妊娠37+1周孕2产0LOA胎膜早破	孕37周##胎膜早破
高级别子宫上皮内病变CINIII	子宫颈上皮内瘤变III级[CINIII级]
首诊房颤	心房颤动[心房纤颤]
颞颌关节强硬	颞下颌关节强直
脂肪酶升高原因待查胰腺炎	高脂肪酶血症##胰腺炎
阴蒂黑色素瘤切除术后	恶性黑色素瘤##阴蒂恶性肿瘤
左眼人工晶体眼左眼晶体皮质残留	玻璃体内晶状体皮质残留##人工晶体植入状态
胃窦中低分化腺癌IV期	胃窦恶性肿瘤##腺癌
多脏器功能不全累及肝脏肾脏凝血心肌呼吸	多脏器功能障碍综合征[MODS]
甲状腺双叶滤泡型腺瘤	肾上腺良性肿瘤##滤泡性腺瘤
双侧乳腺增生左侧乳腺实性结节	乳腺增生##乳房结节
侧脑室心房分流术后	脑脊液分流状态
右小指无力待查副肿瘤综合症	副肿瘤综合征
"腰重度疼痛,椎体多发骨破坏,左肺上叶肺癌？,肝转移"	腰痛##骨质破坏##左肺上叶恶性肿瘤##肝继发恶性肿瘤##癌##转移性癌
睡眠呼吸低通气综合征	睡眠低通气综合征
肝，肠MT术后	肝恶性肿瘤##肠道恶性肿瘤
腰骶部软组织劳损	腰椎和骨盆其他和未特指部位的扭伤和劳损
左下下颌骨纤维异样增殖症良性	颌骨纤维异常增殖症
右颌下口底静脉畸形	周围静脉畸形
肺错构瘤	肺错构瘤
"右肾癌肺转移,右肾切除术后,腹腔腹膜转移"	肾恶性肿瘤##肺继发恶性肿瘤##肾术后##腹膜继发恶性肿瘤##腹腔继发恶性肿瘤##癌##转移性癌
膝关节骨关节炎疼痛行动不便	膝骨关节病##膝关节痛
T12L1后缩性骨折	胸椎压缩性骨折##腰椎骨折L1##腰椎压缩性骨折
双跟骨骨折	跟骨骨折
左喉部占位	口腔和咽喉部占位
右肺下叶鳞状细胞癌	右肺下叶恶性肿瘤##鳞状细胞癌
左肺上叶下舌段细支气管扩张并少许纤维灶	支气管扩张症##肺诊断性影像异常
肛管-直肠癌	肛管及直肠恶性肿瘤##癌
胸髓萎缩伴空洞	脊髓萎缩##脊髓空洞症
停经283周发现胎儿心脏继发隔显示不清	妊娠状态
植物神经紊乱中度焦虑轻度抑郁	焦虑状态##抑郁状态##植物神经功能紊乱
右侧额颞叶脑挫裂伤出血	多发性大脑挫裂伤##创伤性颅内出血
甲状腺乳头状腺癌	甲状腺恶性肿瘤##乳头状腺癌
肾透明细胞癌术后	肾恶性肿瘤##透明细胞癌##肾术后
A1B1半脱位A2牙松动	牙脱位
拇趾外翻畸形	足拇外翻
脑缺血脱髓鞘锥体外系	脱髓鞘性脑病##脑血管供血不足
周围神经炎	多发性神经病[多发性神经炎/周围神经炎]
急性胆囊炎并胆囊结石	胆囊结石伴急性胆囊炎
胸11椎体压缩性改变	胸椎压缩性骨折
双手神经病变	多发性神经病[多发性神经炎/周围神经炎]
双眼慢性开角型青光眼	开角型青光眼
肝动脉灌注化疗后	化学治疗
双足副舟骨源性平足症垂直距骨	先天性足副舟骨##扁平足
孕31周贫血	孕31周##妊娠合并贫血
唇及颊部扁平苔藓	扁平苔癣
多发椎体横突骨折	脊柱骨折##多发性骨折
十二指肠乳头符合管状腺瘤	十二指肠良性肿瘤##管状腺瘤
全脊髓放疗后	放射治疗
右手指冻伤伤口换药	冻伤##手指损伤
颅骨巨细胞瘤	骨巨细胞瘤##颅骨良性肿瘤
胃窦隆起型病变憩室可能	胃憩室
左胫前远端恶性黑素瘤T4N0M0IIC期	下肢恶性黑色素瘤##恶性黑色素瘤
继发干燥综合	继发性干燥综合征
胃底胃体癌综合治疗后	胃底及胃体恶性肿瘤##癌
腹膜转移	腹膜继发恶性肿瘤##转移性肿瘤
部分性发作继发全身发作	癫痫部分性发作##癫痫大发作状态
左乳外上不对称致密	乳房未特指的疾患
阵发性房颤伴终止后长RR间歇	阵发性心房颤动##R-R长间歇
子宫绒癌化疗	子宫恶性肿瘤##绒毛膜癌##化学治疗
直肠腺癌根治术后pT2N0M0	直肠术后##直肠恶性肿瘤##腺癌
消化不良(+内脏感觉过敏)	消化不良
十二指肠球降交界符合低级别管状腺瘤早期	十二指肠交界性肿瘤##管状腺瘤
右肾右输尿管全切术后	肾术后##输尿管术后
慢性支气管炎继发感染腰背部疼痛行动不便	慢性支气管炎##感染##腰背痛
双肺间质性肺疾病并肺纤维化	间质性肺病##肺纤维化
左肩多发性脱位	肩胛带关节和韧带脱位、扭伤和劳损
右侧外耳道闭锁2右侧听力障碍	听功能障碍
角膜伤口愈合不良右	开放性损伤愈合不良
双肾输尿管梗阻性病变	梗阻性肾病##输尿管梗阻
肝脏肾上腺占位	肝占位性病变##肾上腺占位
右侧肾盂癌根治术	肾盂恶性肿瘤##癌##肾术后
肝组织内分化腺癌	肝恶性肿瘤##腺癌
右胫骨骨暴露	下肢开放性损伤
小儿急性喉-支气管炎	急性支气管炎##急性喉炎
慢性移植物抗宿主反应病口腔关节皮肤	慢性移植物抗宿主病
口腔黏膜擦伤	口腔和咽喉部损伤
肠病毒性结膜炎	病毒性结膜炎
右足骨关节炎	骨关节病
喉高分化鳞状细胞癌	喉恶性肿瘤##鳞状细胞癌
乳腺恶性肿瘤的支持治疗	乳腺恶性肿瘤##恶性肿瘤支持治疗
右踝距腓前韧带撕脱性骨折前踝软组织撞击症	踝关节撞击综合征##踝骨骨折
慢性乙肝病毒性肝炎（活动期）	慢性乙型病毒性肝炎
双侧基底节区多发陈旧腔梗	基底节脑梗死##腔隙性脑梗死##多发性脑梗死##陈旧性脑梗死
间断性EP发作3次双下肢挛缩	癫痫
面颈部皮下瘀伤	面部损伤##颈部损伤
面部双手多处划伤	面部开放性损伤##手部开放性损伤
左侧肾动脉支架植入术后状态	血管支架植入术后状态
"肠癌肝转移？,肠镜检查,出血倾向"	肠道恶性肿瘤##癌##肝继发恶性肿瘤##转移性癌##出血倾向
"高脂血症,膀胱癌术后"	高脂血症##膀胱术后##膀胱恶性肿瘤##癌
原发性扩张型心肌病，全心扩大，心房纤颤、偶发室性早搏，心功能Ⅲ级	扩张性心肌病[充血性心肌病]##心脏扩大##心房颤动[心房纤颤]##室性期前收缩##心功能III级(NYHA分级)
左上臂开放性犬咬伤	上肢开放性损伤##被狗咬伤
双四肢神经元损伤	上肢神经损伤##下肢神经损伤
左膝关节内侧半月板后角附着点撕脱性骨折	膝关节骨折
乳癌免疫力低下	乳腺恶性肿瘤##癌
子宫颈病变CIN--IIHPV感染	宫颈上皮瘤样病变[CIN]II级##人乳头瘤病毒感染
宫颈低级别病变CINII级	宫颈上皮瘤样病变[CIN]II级
急性移植物抗宿主反应肠道	急性移植物抗宿主病
右耳听力重度障碍左耳听力中度障碍	听功能障碍
右足第1跖骨头撕脱性骨折	跖骨骨折
排便困难原因待查结直肠病变不能排除	排便困难##肛门和直肠未特指的疾病
骨髓增生异常综合征转化为急性白血病	骨髓增生异常综合征
右膝关节盘状半月板撕裂	先天性盘状半月板##膝半月板撕裂
2慢性肾脏疾病CKD3级	"慢性肾脏病,3期"
双肾盂输尿管上段积液	输尿管积水##肾积水
恶性肿瘤的姑息化疗	化学治疗
妊娠40＋1周，孕1产0，单活胎，LOA	孕40周
符合巨幼红细胞性贫血骨髓改变	巨幼红细胞性贫血
躯体化症状肝郁脾虚	躯体化障碍
右颈部低分化癌	颈部恶性肿瘤##癌
结肠肝曲结肠脾区管状腺瘤部分腺体较增生	管状腺瘤##结肠肝曲良性肿瘤##结肠脾曲良性肿瘤
母体前置胎盘新生儿	胎儿和新生儿受前置胎盘的影响
双肾多发囊肿伴部分出血	肾囊肿
双眼闭角型青光急性大发作	闭角型青光眼
"体表肿瘤活检 喉癌术后,复查开药 胃镜检查"	喉术后##喉恶性肿瘤##癌
双卵巢中低分化浆液性乳头状囊腺癌	卵巢恶性肿瘤##乳头状浆液性囊腺癌
皮肤paget病	湿疹样癌[佩吉特病][Paget病]
髋关节疾病待查	髋骨关节病
先天性纤维蛋白原减少症	先天性纤维蛋白原缺乏血症
慢性家族性良性天疱疮	良性慢性家族性天疱疮
肱骨病理性骨折	肱骨骨折##病理性骨折
垂体机能减退综合征Simmond病	腺垂体功能减退症
心肌酶异常原因风湿免疫系统疾病可能性大	心肌酶谱异常##风湿病
右肾缩小右肾弥漫性病变	肾病##肾萎缩
右侧头臂干粥样硬化伴狭窄	动脉粥样硬化##动脉狭窄
学习困难.铅高	学习技能发育障碍##铅中毒
胸腰椎侧弯畸形	脊柱侧弯
面部带状庖疹	带状疱疹
右环指软组织坏死缺损骨外露	手坏死
起搏器囊袋感染清创术后	清创术后##心脏电子装置囊袋感染
左膝内侧滑膜皱综合征	膝关节滑膜皱襞综合征
胃窦中-低分化管状腺癌	胃窦恶性肿瘤##管状腺癌
重症2呼吸窘迫	急性呼吸窘迫综合征
双膝关节骨关节炎	双侧膝关节骨性关节病
绒毛状腺瘤伴癌变	绒毛状腺瘤##腺瘤癌变
多发颅神经炎面神经三叉神经前庭神经	多发性脑神经炎##面神经炎##三叉神经炎##前庭神经炎
双眼小柳原田综合症晚期	Vogt-小柳原田综合征
颅内及颈部动脉多发斑块及狭窄	动脉狭窄##颈动脉狭窄
直肠绒毛管状腺瘤直肠绒毛管状腺瘤	管状绒毛状腺瘤##直肠良性肿瘤
腰大池引流术后	具有脑脊液引流装置
右中指感染异物残留？	手指感染
急性化脓性阑尾炎伴坏疽	急性化脓性阑尾炎##坏疽
脑缺血脱髓鞘右半身僵	脱髓鞘性脑病##脑血管供血不足
眼球内异物	眼球异物
肿瘤特殊筛查CA125TPSA升高	肿瘤标记物升高
膀胱粘膜上皮鳞状化生白斑	膀胱白斑##膀胱鳞状上皮化生
宫颈节育器移位	避孕环移位
结肠绒毛-管状腺瘤伴有局部上皮内瘤变	结肠良性肿瘤##管状腺瘤
右肺尖纤维硬结灶性质待查	肺诊断性影像异常
慢性萎缩性胃窦炎伴糜烂	慢性萎缩性胃炎##糜烂性胃炎
返流食管炎消化性溃疡	反流性食管炎##消化性溃疡
龟头型尿道下裂	"尿道下裂,龟头的"
食管鳞ca 胃食管结合部腺ca	食管恶性肿瘤##鳞状细胞癌##食管胃连接部恶性肿瘤##腺癌
十二指肠降段隆起性病变	胃和十二指肠未特指的疾病
闭合性脑外伤1左侧额顶部硬膜外血肿	创伤性硬脑膜外血肿
腹部手术后乏力	乏力
2型糖尿病眼病	非胰岛素依赖型糖尿病伴有眼的并发症
G2p0孕36+5周待产LoA完全性前置胎盘副胎盘可能	孕36周##中央性前置胎盘##妊娠合并副胎盘
双侧原发性膝关节病	膝关节病
左颊部涎腺粘液囊肿	唾液腺粘液囊肿
右乳乳腺浸润性导管癌	乳腺恶性肿瘤##浸润性导管癌
短暂性全面性遗忘症	短暂性全面遗忘
鼻咽低分化鳞癌伴肝转移	鼻咽恶性肿瘤##鳞状细胞癌##肝继发恶性肿瘤##转移性癌
甲癌复发	甲状腺恶性肿瘤##癌##恶性肿瘤复发
卵巢癌化疗后骨髓抑制	卵巢恶性肿瘤##化疗后骨髓抑制##癌
恶性肿瘤生物靶向治疗	恶性肿瘤生物治疗##恶性肿瘤靶向治疗
双肺磨玻璃灶纤维硬结灶	肺诊断性影像异常
骶尾部皮脂腺瘤	皮脂腺瘤
胆管细胞性肝癌	肝恶性肿瘤##肝胆管细胞癌
胃体癌伴腹腔种植转移化疗后（ⅠV）	胃体恶性肿瘤##癌##腹腔继发恶性肿瘤##化学治疗
双下肢肢体发育不良	先天性发育异常
胃酸返流	反酸
头部蜂蜇伤复诊	蜂螫伤##头部损伤
胎儿盆腔异位肾可能	肾异位
肝肝细胞异型增生胆管增生	肝细胞不典型增生##胆道不典型增生
骨盆尤文肉瘤	尤因肉瘤##骨盆恶性肿瘤
浅表性威严伴糜烂	慢性浅表性胃炎##糜烂性胃炎
左侧肢体乏力待查颈椎病高血压	肢体无力##颈椎病##高血压
左拇指指骨基底部陈旧性撕脱性骨折	拇指骨折
掌跖角皮病恶性黑素瘤	恶性黑色素瘤##掌跖角化
右跟腓韧带止点撕脱性骨折	跟骨骨折
双耳感音神经性聋，耳源性眩晕不能完全除外	感音神经性聋##耳源性眩晕
左下肢针刺伤	"下肢未特指的损伤,水平未特指"
翼状胬肉切除术（单眼）	翼状胬肉##眼术后
左侧气胸41双侧胸部颈部皮下气肿	气胸
1贲门病变套切治疗后	胃和十二指肠未特指的疾病##胃术后
右小腿截肢气血瘀滞经络不畅	截肢
晚孕32单活胎G-6-PD缺乏症	妊娠状态##蚕豆病
口咽部消化道化学灼伤	消化道化学伤
双肺尖少许肺纤维化放疗后改变	放射治疗##肺纤维化
"右肺下叶小细胞肺癌 广泛期,食管胸中段癌食道溃疡狭窄,咳嗽 便秘化疗呕吐,食欲减退抗过敏,水肿利尿"	右肺下叶恶性肿瘤##小细胞癌##食管胸中段恶性肿瘤##癌##食管溃疡##食管狭窄##咳嗽##便秘##化疗药物反应##呕吐##食欲不振##水肿
右附睾头囊肿	附睾囊肿
左侧DDH继发OA双膝OA	先天性髋关节发育不良##双侧膝关节骨性关节病##髋骨关节病
骨盆及C6放疗后	放射治疗
Ebstein畸形	埃布斯坦畸形[Ebstein畸形]
停经22周B超提示胎儿右侧肺内异常回声	孕22周
肾错构瘤右	肾错构瘤
周围神经病变化手脚麻木	多发性神经病[多发性神经炎/周围神经炎]
升结肠1符合管状腺瘤升结肠2管状腺瘤	升结肠良性肿瘤##管状腺瘤
乙状结肠管状腺瘤伴低度上皮内瘤变	管状腺瘤##乙状结肠良性肿瘤
右拇趾外伤拔甲术后	足趾损伤
扁平骨盆致梗阻性分娩	扁平骨盆引起的梗阻性分娩
左尺神经挫伤	身体未特指部位的神经损伤
肾癌术后晚期 严重肝损伤	肾恶性肿瘤##肾术后##肝损害##癌
意识障碍原因待查低血糖发作脑缺血发作	意识障碍##低血糖症##脑血管供血不足
支气管肺炎(恢复期)，感染性腹泻腹泻病	支气管肺炎[小叶性肺炎]##恢复期##感染性腹泻
十二指肠粘膜下病变淋巴管扩张可能	肠淋巴管扩张
慢性粒细胞白血病不典型	慢性粒细胞性白血病##慢性粒细胞白血病
Ⅰ度房室传到阻滞变异型院时情况	一度房室阻滞
右髌骨骨挫伤	髌骨骨折
双下肢皮肤搔痒症	瘙痒症
甲状腺囊肿切除术后	甲状腺囊肿##甲状腺术后
结缔组织增生性黑素瘤待排	恶性黑色素瘤
出血性血小板增多症	原发性血小板增多症
颈椎、椎间盘退行性病变	颈椎间盘变性
左腰不适；左肾结石；胆囊炎	肾结石##胆囊炎
粟粒疹	痱子
"左肾集合管癌,化疗后白细胞减少,发热,上呼吸道感染,咳嗽 痰中带血,化疗后血小板低"	肾恶性肿瘤##集合管癌##化疗药物反应##白细胞减少##发热##上呼吸道感染##咳嗽##化疗药物反应##药物性血小板减少
口干、右上下肢不适待查	口干
大腿神经纤维瘤	神经纤维瘤病[VonRecklinghausen病]
胆囊及胆总管结石	胆囊结石##胆总管结石
早产胎膜早破	胎膜早破
肾上腺皮质发育不全	肾上腺发育不良
妊娠伴有1型糖尿病	妊娠合并糖尿病##1型糖尿病
弥漫性大B细胞癌	弥漫大B细胞淋巴瘤
大颗粒T淋巴细胞白血病	淋巴细胞白血病
颈动脉粥样硬化并斑块形成	颈动脉粥样硬化
左侧股骨头坏死	股骨头缺血性坏死
食道-胃底静脉重度曲张	胃底静脉曲张##食管静脉曲张
"右上臂麻木,颈椎片显示颈椎病"	颈椎病
多脏器功能不全肝肾凝血功能障碍	多脏器功能障碍综合征[MODS]##肝功能异常##凝血功能障碍##肾功能异常
胎儿异常两胎儿胎儿部分肠管扩张	多胎妊娠
右下肺送检组织支气管囊性扩张倾向支	支气管扩张症
双侧侧脑室前角白质轻度变性7左房增大	脑白质病
肝MT5次介入术后1月余	肝恶性肿瘤##肝术后
高血压病(左房大)	高血压##左房扩大
车祸机动车翻车致伤面部及腿部	"面部损伤##下肢未特指的损伤,水平未特指"
小儿原发性肾病综	肾病综合征
主观性头昏重度焦虑伴躯体化	头晕##焦虑状态
躯体化功能障碍周围神经病变	多发性神经病[多发性神经炎/周围神经炎]##躯体性机能障碍
肺瘢痕癌	肺恶性肿瘤##癌
周围神经病变保守治疗后	多发性神经病[多发性神经炎/周围神经炎]
"G1P0孕37+2周临产LOA,中度贫血"	孕37周##中度贫血
膝关节交锁待查	膝关节内部紊乱
多脏器功能障碍肝脏肺心脏肾凝血系统	多脏器功能障碍综合征[MODS]
左侧面部狗抓伤	面部开放性损伤##被狗抓伤
左尺侧副韧带止点撕脱性骨折	尺侧副韧带断裂
左回旋支闭塞多支轻-中度狭窄	冠状动脉狭窄##冠状动脉闭塞
头昏胀高TC	头晕##高胆固醇血症
胰后脾静脉海绵样变肠系膜上静脉海绵样变	脾血管瘤##肠系膜血管瘤##海绵状血管瘤
肾上腺皮质腺瘤	肾上腺皮质腺瘤##肾上腺良性肿瘤
移植肾积水	肾移植状态##肾积水
左室向心性肥厚左房增大	心室肥厚
面部双上肢皮肤抓伤	面部开放性损伤##上肢开放性损伤
筛上颌窦炎鼻息肉	筛窦炎##上颌窦炎##鼻息肉
咳嗽(感染后)	感染##咳嗽
前列腺特指疾病高PSA血症	PSA升高##前列腺其他特指的疾患
肛周湿疣	肛门生殖器疣
痛风别嘌醇过敏	痛风##激素药物反应
双侧颈内动脉内膜病变伴斑块形成	颈内动脉斑块
腘动脉动脉瘤	腘动脉瘤
胃十二指肠多发溃疡伴幽门梗阻	胃溃疡##十二指肠溃疡##幽门梗阻
双侧基底节区腔隙灶老年性脑改变	腔隙性脑梗死
轻度胰腺炎	胰腺炎
胆栓综合症	胆汁浓缩综合征
珠蛋白生成障碍性贫血	地中海贫血
胸腰椎退行改变	胸椎退行性病变##腰椎退行性病变
食管溃疡型鳞癌	食管恶性肿瘤##鳞状细胞癌
肝硬化门脉高压.脾肿大.脾功能亢进，食道胃底静脉曲张	肝硬化##门脉高压##脾大##脾功能亢进##胃底静脉曲张##食管静脉曲张
肾癌(左)	肾恶性肿瘤##癌
狭颅症(额缝早闭)	颅缝早闭
糖尿病性肾病III期	糖尿病肾病III期
双下肢无力原因一氧化碳中毒性周围神经病	肢体无力##一氧化碳中毒后遗症##多发性神经病[多发性神经炎/周围神经炎]
肾组织轻度病变伴球性硬化75	肾小球硬化
睡眠障碍伴焦虑	睡眠障碍##焦虑状态
颈部粉瘤感染	颈部皮脂腺囊肿##感染
左侧咬肌区肿块（血管瘤？)	面部肿物##血管瘤##血管瘤
CINII级累及腺体可见挖空细胞	宫颈上皮瘤样病变[CIN]II级
先天性鳃裂囊肿	鳃裂囊肿
db0主气管阻塞db	呼吸道梗阻
双手麻木原因末梢神经病	末梢神经病[末梢神经炎]
外阴撕裂伤	外阴开放性损伤
肝硬化\便血	肝硬化##便血
双卵巢粘液性低分化腺癌	卵巢恶性肿瘤##腺癌
特指口区囊肿新口底	口腔囊肿
染色体异常口腔功能障碍	染色体病
先天发育不良	先天性发育异常
乳腺多发纤维腺瘤	纤维腺瘤##乳腺良性肿瘤
眼睑静脉畸形	周围静脉畸形
重叠结缔组织综合征	重叠综合征
粒细胞缺乏伴肺部感染	粒细胞缺乏##肺部感染
右上肺小细胞肺癌脑、骨转移 广泛期	右肺上叶恶性肿瘤##小细胞癌##脑继发恶性肿瘤##骨继发恶性肿瘤##转移性小细胞癌 
副乳腺(腋下)	副乳
送检胎盘胎膜组织显退变伴钙盐沉积	钙质沉着症
右乳肿物浸润性导管癌	乳腺恶性肿瘤##浸润性导管癌
右眼睑裂斑双眼MGD	睑板腺功能障碍##睑裂斑
左手中指屈曲无力	肌无力
先天性矫正型大血管转位	矫正性大动脉转位
停经32周B超提示胎儿左侧脑室正常高值	妊娠状态
肉芽肿性小叶炎	乳腺炎性肉芽肿
胸壁尤文肉瘤	尤因肉瘤##胸部恶性肿瘤
急性淋巴细胞白血病B细胞型标危型缓解期	B细胞急性淋巴细胞白血病##急性淋巴细胞白血病伴缓解
左侧腹股沟、阴茎及阴囊皮肤低分化大汗腺癌	腹股沟恶性肿瘤##阴茎恶性肿瘤##阴囊恶性肿瘤##汗腺恶性肿瘤##癌
子宫内膜中分化腺癌Ib期	子宫内膜恶性肿瘤##腺癌
纵膈淋巴结慢性炎症	慢性淋巴结炎
左侧颈动脉内膜符合粥样斑块组织学改变	颈动脉粥样硬化
左腕关节月骨无菌性坏死伴左腕关节反应性滑	成人腕月骨骨软骨病[成人金伯克病]
"非霍奇金淋巴瘤,FL,白细胞减少"	非霍奇金淋巴瘤##滤泡淋巴瘤##白细胞减少
脑出血自发性脑室内出血	脑室出血
头晕心悸待查：高血压;椎-基底动脉供血不全;冠心病心律失常型;心绞痛	头晕##心悸##高血压##椎-基底动脉供血不全##冠心病心律失常型##心绞痛
右上肺陈旧病变伴支气管牵拉性扩张	支气管扩张症
肺侵袭性腺癌	肺恶性肿瘤##腺癌
左下肢扭伤	下肢关节和韧带扭伤
周围神经脱髓鞘周围神经病变	脱髓鞘病##多发性神经病[多发性神经炎/周围神经炎]
抑郁伴躯体形式障碍未特指的	抑郁发作##未特指的躯体形式障碍
慢性浅表性胃炎轻度萎缩	慢性浅表性胃炎##慢性萎缩性胃炎
"结肠癌术后pT4N1M0,肝转移切除术后"	结肠术后##结肠恶性肿瘤##癌##肝继发恶性肿瘤##肝术后##转移性癌##淋巴结继发恶性肿瘤
鼻骨骨折鼻外伤	鼻骨骨折
L5椎体左侧弓峡裂S1隐裂	先天性腰骶椎隐裂
右眼Teson综合症	蛛网膜下腔出血并玻璃体出血症[Terson综合征]
完全性阴道纵隔	阴道纵隔
股外侧皮神经麻痹	皮神经卡压综合征
双眼轮匝肌痉挛	面肌痉挛
急性髓系白血病; 异基因造血干细胞移植术	急性髓系白血病##造血干细胞移植状态
成骨不全双下肢畸形	成骨不全##先天性下肢畸形
病毒性皮肤病	未特指的以皮肤和粘膜损害为特征的病毒性感染
足部筋膜劳损	足的其他和未特指部位的扭伤和劳损
新生儿卵圆孔未闭20mm转归其他	卵圆孔未闭
脑白质缺血性改变右侧基底节区梗塞灶	基底节脑梗死##脑血管供血不足
右眼皮肤挫裂伤	眼睑挫伤##眼睑裂伤
右手多手指完全切断拇指示指缺失	多指完全离断##后天性单侧手指缺失
右跟骨尤文肉瘤	尤因肉瘤##跟骨恶性肿瘤
符合海马硬化改变	海马硬化[颞叶内侧硬化]
脑动脉瘤包裹术后	脑动脉瘤##脑术后
双乳炎性病变	乳腺炎
双乳CA化疗	乳房恶性肿瘤##化学治疗##癌
胸4脊髓肿瘤放疗后	胸髓恶性肿瘤##放射治疗
羊水污染	羊水和胎膜未特指的疾患
肺特指疾患双肺下叶斑片影	肺部阴影##肺病
未分化缔组织病PBC	结缔组织病
F2胎儿FGR合并多发结构异常	胎儿生长受限
带状庖疹后神经疼	带状疱疹后神经痛(B02.2+)
浸润性突眼	突眼性情况
意识丧失伴肢体抽搐	意识丧失##抽搐状态
肠系膜血栓伴疼痛	疼痛##肠系膜静脉血栓形成
门静脉海绵状变性并肝功能-门静脉瘘	门静脉海绵样变
胆总管末端阳性狭窄并低位胆道梗阻	胆管梗阻##胆总管狭窄
右颊粘膜白斑病	口腔粘膜白斑病
RA糖尿病胃炎	类风湿性关节炎##糖尿病##胃炎
右手前臂过敏红肿痒	过敏反应
急性ST段抬高型广泛前壁心肌梗死	急性广泛前壁心肌梗死##急性ST段抬高型心肌梗死
左腕正中神经粘连卡压	正中神经卡压综合征
右侧鼻腔鼻窦新生物Ca可能	鼻腔息肉##鼻窦息肉##鼻腔恶性肿瘤##鼻窦恶性肿瘤##癌
右上肢正中神经鞘瘤	正中神经良性肿瘤##神经鞘瘤
血脂高头闷晕	血脂异常##头晕
胎儿异常胎儿双足内翻	先天性内翻足
多脏器功能不全累及循环肾脏心肌凝血功能	多脏器功能障碍综合征[MODS]
急性喉咽炎	未特指的急性咽炎
下咽癌	下咽恶性肿瘤##癌
右椎动脉及基底动脉支架置入术	血管支架植入术后状态
下肢软组织挫伤	"下肢未特指的损伤,水平未特指"
胎盘残留-胎盘植入	胎盘部分残留不伴出血##胎盘植入不伴出血
心脏起搏器心房电极磨损	具有心脏起搏器状态
"胰腺癌术后复发,疼痛,胰腺外分泌功能不足,梗阻性黄疸,消化道梗阻,危重病人长期不能进食"	胰腺术后##胰腺恶性肿瘤##癌##恶性肿瘤复发##疼痛##手术后胰腺外分泌功能不全##梗阻性黄疸##进食障碍
累及认知功能和意识特	累及认知功能和意识的其他和未特指的症状和体征
胃占位性病变(胃溃疡？肝占位：原发性？转移瘤？)	胃占位性病变##胃溃疡##肝占位性病变##转移性肿瘤
子宫内膜粘液腺癌	子宫内膜恶性肿瘤##粘液腺癌
骨癌	骨恶性肿瘤##癌
动脉和小动脉的其他特指疾患	动脉和小动脉其他特指的疾患
右上肺符合真菌诊断倾向曲霉菌	肺曲霉菌病
周围神经病变尺神经病变	多发性神经病[多发性神经炎/周围神经炎]
左胸左下肢刀伤颈部胸部双上肢枪伤	胸部开放性损伤##下肢开放性损伤##颈部开放性损伤##胸部开放性损伤##上肢开放性损伤##枪击伤
原发巨大肝癌。	肝恶性肿瘤##癌
右下腹一肠管壁可疑结节待查	肠占位
大便次数增多回盲部隆起	大便习惯改变
食管下段胃底静脉轻度曲张可能	胃底静脉曲张##食管静脉曲张
颈外静脉局限性曲张性病变右	静脉曲张
周期性低钾麻庳GD	低钾型周期性瘫痪[低血钾性周期性麻痹/家族性周期性瘫痪]
双侧颊部扁平苔藓免疫异常	扁平苔癣
睑分裂痣	眼睑黑色素痣
腰背筋膜劳损	腰部劳损##背部劳损
"糖尿病,2型糖尿病,2型糖尿病性视网膜病变,冠状动脉性心脏病"	糖尿病##2型糖尿病##2型糖尿病性视网膜病变##冠状动脉性心脏病
上腭癌	腭恶性肿瘤##癌
右冠状动脉远段病变处支架植入术成功	冠状动脉支架植入术后状态
卵巢腺癌III期	卵巢恶性肿瘤##腺癌
腹部脂肪堆积	腹部脂肪增多症
多发张力性水疱右上肢	上肢浅表水疱
双下肢水肿待查：心功能不齐高心病？	下肢水肿##心功能不全##高血压性心脏病
黑毛痣	色素痣
二性症发育不佳	第二性征发育不全
感染性疾病结缔组织疾病血液系统疾病	结缔组织病##血液和造血器官未特指的疾病
双耳异物	耳内异物
鼻炎、腺样体肥大？;	鼻炎##腺样体肥大
直肠中-高分化腺癌CTXNXM1BIVB期	直肠恶性肿瘤##腺癌
扁桃体炎抵抗力低下	扁桃体炎
颈部软组织劳损	肩颈部劳损
右肱骨内上髁炎	内侧上髁炎
背部皮下疖肿	皮肤疖肿
肺源性心脏病失代偿期	肺源性心脏病
冠心病心功能不全心律失常	冠心病心律失常型##心功能不全
右距骨及第5趾骨基底部撕脱性骨折	距骨骨折##指骨骨折
阴道鳞状细胞癌	阴道恶性肿瘤##鳞状细胞癌
三度房室阻滞	三度房室传导阻滞
右足第5趾跖关节囊破裂并关节面缺损	跖趾关节损伤
宫颈中分化内膜样腺癌Ib1期	子宫颈恶性肿瘤##子宫内膜样腺癌
双侧额叶脱髓鞘及缺血性改变可能	脱髓鞘性脑病
(R50.900)发热不除外感染性发热	发热##感染性发热
蹼状指	蹼状指
双基底节区及双额深区多发腔隙性梗死	腔隙性脑梗死##多发性脑梗死##基底节脑梗死
两个或更多手指截断	多指完全离断
先天性右侧Poland综合征	胸大肌缺损并指综合征[Poland综合征]
高血压糖尿病上感	高血压##糖尿病##上呼吸道感染
多脏器功能不全心肾肺凝血	多脏器功能障碍综合征[MODS]
肝脾异常	肝功能异常##脾功能异常
下咽癌合并胸中段食管癌	下咽恶性肿瘤##食管胸中段恶性肿瘤##癌
腕和手多处损伤(分类S60-S68的损伤)	腕部损伤##手部损伤
颅高压综合症	颅内压增高
右颈面部鳞状细胞癌放化疗后	头、面和颈部恶性肿瘤##鳞状细胞癌##恶性肿瘤放疗##化学治疗
慢性阻塞性肺疾病急性期	慢性阻塞性肺疾病
颈椎、腰椎间盘退行性变	颈椎间盘变性
颈部腮裂瘘残留	鳃裂瘘
左下肢无力原因待查左下肢关节病变不除外	肢体无力##关节疾患
孕发不孕阴道假丝酵母菌病POOS	真菌性阴道炎##未特指的女性不孕症
反射性躯体神经病	交感神经反射性营养不良
颈胸椎多发性病变伴四肢不全瘫	不完全性瘫痪##未特指的四肢瘫痪
肛门感觉异常阴部神经症候群	神经症性障碍
右肩部软组织损伤	肩部损伤
鼻咽癌放疗中	鼻咽恶性肿瘤##癌##恶性肿瘤放疗
非霍奇金B细胞淋巴瘤	非霍奇金淋巴瘤(B细胞型)
左眼部挫伤	眼睑及眼周区挫伤
血脂升高	高脂血症
骶尾部外伤后排便困难	排便困难##骨盆部损伤
后天性纯红细胞再生障碍	未特指的后天性纯红细胞再生障碍
右肺中下叶鳞癌	右肺中下叶恶性肿瘤##鳞状细胞癌
右下肢动脉血栓栓塞	下肢动脉栓塞和血栓形成
右颌下腺导管结石伴右颌下腺慢性炎症	下颌下腺导管结石##慢性下颌下腺炎
右股骨骨折右胫骨骨折右下肢皮肤软组织挫裂伤，右肱骨髁上骨折	"股骨骨折##胫骨骨折##下肢未特指的损伤,水平未特指##肱骨骨折##肱骨髁上骨折"
胃肝源性溃疡	胃溃疡
甲亢合并妊娠	妊娠合并甲状腺功能亢进
左手犬抓伤	手部开放性损伤##被狗抓伤
二尖瓣膜置换术后	具有其他心脏瓣膜置换
股骨头坏死(左侧)	股骨头缺血性坏死
1.颈部淋巴结肿物待查2.支气管炎;	颈淋巴结肿大##支气管炎
癌化学治疗后的随诊检查	癌##恶性肿瘤放射治疗后的随诊检查
左冠支前降支远端心肌桥形成不完全型	冠状动脉肌桥
胃食管结合部中重度异型增生	食管粘膜不典型增生##胃粘膜不典型增生
1语言发育落后2智力发育落后	发育迟滞
冠心病—心律失常	冠状动脉粥样硬化性心脏病##心律失常
预计综合症射频消融	预激综合征[沃-帕-怀综合征]##射频消融术后
升结肠低级别管状腺瘤	升结肠良性肿瘤##管状腺瘤
脾脏高度充血致脾肿大	脾大
TC静脉化疗9程	化学治疗
噬血细胞组织综合征	噬血细胞综合征
骨折外伤	骨折
脑梗死;冠状动脉粥样硬化性心脏病;心绞痛;脑动脉硬化	脑梗死##冠状动脉粥样硬化性心脏病##心绞痛##脑血管硬化
宫颈癌术后、下腹痛	宫颈术后##子宫颈恶性肿瘤##癌##下腹痛
代谢性酸中毒合并高钾血症	代谢性酸中毒##高钾血症
吞咽梗阻	吞咽困难
步态不稳原因待查缺血性脊髓血管病变	缺血性脊髓血管病##异常步态
中枢神经系统EB病毒感染	中枢神经系统感染##EB病毒感染
发热伴抽搐原因待查	发热##不明原因抽搐
胰尾部恶性病变	胰尾恶性肿瘤
口腔黏膜癌	口腔粘膜恶性肿瘤##癌
孕37周防婴儿佝偻病妊娠期补钙	妊娠状态
回盲部肠外肿瘤	回盲部肿瘤
消化系统合并症：①慢性非萎缩性胃炎伴胆汁反流（轻度）②十二指肠炎③Barrett食管④肝右叶多发小囊肿⑤肝右叶钙化灶	消化系统其他特指的疾病##慢性浅表性胃炎##胆汁反流##十二指肠炎##巴氏食管##肝囊肿##肝钙化灶
T45椎体破坏伴全瘫	完全性瘫痪
急性髓性白血病M3	急性早幼粒细胞白血病(M3型)
生育问题(畸形精子)	畸形精子症
双眼高压眼底病变I级	高眼压症
泌乳素瘤	垂体泌乳素瘤##垂体良性肿瘤
晚孕胎儿头皮迟缓	妊娠状态
鼻背部色斑	色素斑
颈动脉硬化狭窄	颈动脉硬化##颈动脉狭窄
浮肿待查大便改变	水肿##其他大便异常
双侧乳癌根治术	双侧乳腺恶性肿瘤##癌##化学治疗
进镜距肛门20cm处管状腺瘤	管状腺瘤##乙状结肠良性肿瘤
双肩跌伤	摔伤##肩部损伤
右上肺CA	右肺上叶恶性肿瘤##癌
脑动脉硬化;乏力;耳鸣;脑血管供血不足	乏力##耳鸣##脑血管供血不足##脑血管硬化
心肌缺血心功能降低	心肌供血不足
部分性发作继发全身强直阵挛发作	癫痫大发作[全身强直-阵挛性发作]
妊娠合并IgA肾病	IgA肾病##妊娠状态
宫颈节育器下移伴嵌顿	避孕环嵌顿##避孕环移位
直肠中分化管状腺癌维持性化学治疗	直肠恶性肿瘤##管状腺癌##恶性肿瘤维持性化学治疗
左頰粘膜磷Ca	鳞状细胞癌##颊粘膜恶性肿瘤
空肠中段粘膜病变并狭窄	肠未特指的疾病##肠狭窄
右侧大脑后动脉粥样硬化	脑动脉粥样硬化
全麻喉部分切除术全喉准备	喉术后
先天性大疱性表皮松解可能性大	大疱性表皮松解症
右侧腓深神经损伤	腓神经损伤
左颞骨面神经瘤	神经瘤##面神经良性肿瘤
左乳肿块癌	乳房肿物##乳腺恶性肿瘤##癌
多原发结肠癌MSI	结肠恶性肿瘤##癌
L1椎体压缩骨折	腰椎压缩性骨折
双侧乳腺腺瘤术后	乳腺良性肿瘤##腺瘤##乳腺术后
急性粒单核细胞白血病	急性粒单核细胞白血病(M4型)##急性粒-单核细胞白血病
左内踝及外踝撕脱性骨折	外踝骨折##内踝骨折
慢性心衰急性加重期全心衰NYHAⅣ级C期	慢性心功能不全急性加重##心功能IV级(NYHA分级)
肝囊肿(术后)	肝囊肿##肝术后
甲状腺未分化癌	甲状腺恶性肿瘤##未分化的癌
腹主动脉扩张伴硬化	腹主动脉硬化##腹主动脉扩张
慢性肾脏病矿物质及骨异常	慢性肾病##矿物质代谢紊乱
维生素A缺乏干眼症	维生素A缺乏干眼症
"胃体癌，弥漫型,胃镜检查,超声胃镜检查,出血倾向,贫血"	胃体恶性肿瘤##癌##出血倾向##贫血
前列腺癌	前列腺恶性肿瘤##癌
右第5肋局部骨皮质破坏	骨质破坏
右肺下叶癌	右肺下叶恶性肿瘤##癌
颈椎间盘脱出	颈椎间盘突出
双眼高度近视性黄斑病变	变性性近视[病理性近视][高度近视]
食管癌根治术	食管恶性肿瘤##癌
右腰部包块	腰部占位
特发性肺动脉高血压	原发性肺动脉高压
（左颈部）非霍奇金淋巴瘤，B小淋巴细胞淋巴瘤	非霍奇金淋巴瘤##B细胞慢性淋巴白血病/小淋巴细胞淋巴瘤
脑心血管病	脑血管病##未特指的心血管疾病
腋下淋巴结恶性肿瘤	未特指的淋巴结恶性肿瘤
中枢性损害提示脑干水平改变	脑干损伤
宫颈病变环切术后	宫颈术后
右侧髋臼炎症	髋关节炎
右半结肠胆管腺癌	结肠恶性肿瘤##胆管腺癌
右肺小细胞肺癌IV期	右肺恶性肿瘤##小细胞癌
十二指肠癌	十二指肠恶性肿瘤##癌
颈动脉狭窄支架术后	颈动脉狭窄##血管支架植入术后状态
牙龈癌放疗	牙龈恶性肿瘤##癌##恶性肿瘤放疗
酒精中毒性精神障碍	酒精所致的精神病性障碍
右肺上叶腺癌T1bN0M1b Ⅳ期 化疗	右肺上叶恶性肿瘤##腺癌##化学治疗
宫颈中低分化腺癌	子宫颈恶性肿瘤##腺癌
腰椎管狭窄症：L4/5椎间盘突出；	腰椎管狭窄##腰椎间盘突出
下腹部包块待查；双侧腹股沟疝气术后	腹部肿物##双侧腹股沟疝##腹股沟术后
左眼黄斑穿孔	黄斑裂孔
急性前壁非ST段抬高型心肌梗死	急性非ST段抬高型心肌梗死
喉癌放疗	喉恶性肿瘤##癌##恶性肿瘤放疗
"卵巢癌,尿频？"	卵巢恶性肿瘤##癌##尿频
右手小指瘢痕挛缩伴活动受限	手指瘢痕##瘢痕挛缩
阵发性心房纤维化颤动	心房颤动[心房纤颤]
"右侧乳腺癌术后 化疗,重度骨质疏松骨折 消肿止痛,右锁骨上淋巴结转移,关节痛，失眠"	乳腺术后##乳腺恶性肿瘤##恶性肿瘤术后化疗##重度骨质疏松##骨折##锁骨上淋巴结继发恶性肿瘤##关节痛##失眠##癌
双眼脉络膜缺损右侧黄斑病变	视网膜病##先天性脉络膜缺损
MODS肝肾心功能障碍	多脏器功能障碍综合征[MODS]##肾功能异常##肝功能异常##心功能不全
乳房，未特指(C50.9)	未特指的乳房恶性肿瘤
肝门胆管癌（pT2N1）	肝门胆管恶性肿瘤##胆管癌
支气管哮喘慢性阻塞性肺疾病重叠综合征	支气管哮喘##慢性阻塞性肺疾病
文身	纹身
神经痛(耳)	神经痛
阻塞性肺疾病伴限制性通气倾向	慢性阻塞性肺疾病
交界性黏液性腺纤维瘤	粘液性腺纤维瘤
高血压病(左房扩大)	高血压##左房扩大
右乳乳腺增生并导管扩张	乳腺增生##乳腺导管扩张症
化疗后血小板减低症	化疗药物反应##药物性血小板减少
极重度再生障碍性贫血	再生障碍性贫血
舌疾患沟纹舌	舌未特指的疾病##沟纹舌
食道反流	胃食管反流
"右肺下叶腺癌 cT4N3M1 IV期,双肺转移,纵隔、右肺门、右锁骨上淋巴结转移,右胸膜转移可能"	右肺下叶恶性肿瘤##肺继发恶性肿瘤##腺癌##纵隔淋巴结继发恶性肿瘤##肺门淋巴结继发恶性肿瘤##锁骨上淋巴结继发恶性肿瘤##胸膜继发恶性肿瘤##转移性腺癌
常染色体显性多囊肾	常染色体显性遗传的多囊肾病
肝切除射频治疗后	肝术后##恶性肿瘤射频治疗
急性脑梗死右侧额叶皮层下小梗死	脑梗死
先天性无肛伴舟状窝瘘	先天性肛门闭锁伴有瘘
右中下肺癌	右肺中下叶恶性肿瘤##癌
"肺癌晚期术后复发放疗低硒,咯血,疼痛,咳嗽,恶心,呕吐"	肺术后##肺恶性肿瘤##恶性肿瘤放疗##硒缺乏##咯血##疼痛##咳嗽##恶心##呕吐##恶性肿瘤复发##癌
"约4mm2涎腺组织可见淋巴细胞、浆细胞浸润灶2个,间质纤维组织增生,腺泡萎缩.符合干燥综合征涎腺病理改变."	干燥综合征[舍格伦综合征]
双膝重度OA右侧平足伴OA	双侧膝关节骨性关节病##骨关节病##扁平足
右乳浸润性癌非特殊类型	乳腺恶性肿瘤##癌
左颞下颌关节紊乱综合征感染？	颞下颌关节紊乱病##感染
不全性流产	"未特指的流产,不完全性,无并发症"
认知功能减退	认知障碍
结肠癌术后每日更换造口袋1-2个	结肠术后##结肠恶性肿瘤##结肠造口状态##癌
发作性左上肢僵硬发作	肢体无力##肢体僵硬
膀胱癌新辅助性化疗	膀胱恶性肿瘤##化学治疗##癌
右肺腺癌综合治疗后	右肺恶性肿瘤##腺癌
周围神经病变桡神经病变右侧	多发性神经病[多发性神经炎/周围神经炎]
卵圆孔未闭发泡实验阳性	卵圆孔未闭
碱性药物灼伤11%浅Ⅱ度四肢主治	上肢腐蚀伤##下肢腐蚀伤
左下肺炎性假瘤合并肺脓肿	肺炎性假瘤##肺脓肿
急进型肾炎	急进性肾小球肾炎
左腹膜后淋巴结转移癌	腹膜后淋巴结继发恶性肿瘤##转移性癌
甲状腺腺瘤切除术后	甲状腺良性肿瘤##腺瘤##甲状腺术后
特指大便异常原因待查未除肠道病变	其他大便异常##肠未特指的疾病
腹腔继发恶性肿瘤放疗后	腹腔继发恶性肿瘤##恶性肿瘤放疗
左乳肿块:乳癌	乳房肿物##乳腺恶性肿瘤##癌
"胰尾癌术后复查,便秘,焦虑抑郁状态,癌性疼痛，无法口服止痛药,功能性消化不良"	胰腺术后##胰尾恶性肿瘤##癌##便秘##焦虑障碍##抑郁状态##消化不良##癌性疼痛
"周围神经炎,痛风"	多发性神经病[多发性神经炎/周围神经炎]##痛风
全身多发性骨质改变腰23不稳	腰椎不稳定
肾盂肾盂输尿管连接处肾盏恶性肿瘤	肾盏恶性肿瘤##肾盂输尿管连接部恶性肿瘤
肝穿组织中度急性排异反应不除外	肝移植物急性抗宿主病
胎盘异常回声1胎膜下血肿3胎盘早剥3其他	胎盘早期剥离伴出血
右颊粘膜右舌背扁平苔藓伴轻糜免疫异常	口腔扁平苔癣##舌扁平苔癣
75牙髓炎，74、64、65深龋，55、63中龋	牙髓炎##龋病##龋病
颈部、锁骨上、腹腔淋巴结转移	颈部淋巴结继发恶性肿瘤##锁骨上淋巴结继发恶性肿瘤##腹腔淋巴结继发恶性肿瘤
背部pnet化疗	原始性神经外胚瘤##化学治疗
残胃隆起性病变不除外复发	胃和十二指肠未特指的疾病
非胰岛素依赖型糖尿病并眼部病变	非胰岛素依赖型糖尿病伴有眼的并发症
白质发育不良	先天性脑发育不全
发作性头昏原因待查脑血管功能紊乱	头晕##脑血管病
风湿性心脏瓣膜病	风湿性心脏病##心脏瓣膜病
腭部慢性涎腺炎伴脂肪组织瘤样增生	慢性唾液腺炎##脂肪瘤
肺部癌	肺恶性肿瘤##癌
停经265周B超提示下腔静脉缺如	妊娠状态##先天性下腔静脉缺如
"颈部淋巴结肿大原因待查,甲状腺癌术后"	颈淋巴结肿大##甲状腺术后##甲状腺恶性肿瘤##癌
重度关节炎双膝	双侧膝关节骨性关节病##重度骨关节病
停经236周B超提示胎儿心脏双主动脉弓	妊娠状态##先天性双主动脉弓##胎儿先天性心脏病
脊柱退变异位骨化	脊柱骨关节病
右侧附件区囊性异常密度影	其他特指身体结构诊断性影像检查的异常所见
右侧小脑半球腔隙性梗死	小脑梗死##腔隙性脑梗死
儿童多动症复杂性高热惊厥	注意缺陷与多动障碍##热性惊厥
指甲异常微量元素缺乏	微量元素缺乏症
心功能III级(KILLIP分级)	KillipIII级
先天性肺囊肿并感染	先天性肺囊肿##肺部感染
乳腺增生并导管扩张及纤维腺瘤样增生	乳腺增生##乳腺导管扩张症##纤维腺瘤##乳腺良性肿瘤
急性化脓性阑尾炎并坏疽穿孔	急性化脓性阑尾炎伴穿孔##坏疽
右拇指开放性脱位	拇指关节脱位##拇指开放性损伤
寰枢椎异常信号影	其他特指身体结构诊断性影像检查的异常所见
宫内晚孕橫位	妊娠状态
婴幼儿肝细胞癌	肝母细胞瘤
右枕部颅骨骨折	颅骨骨折
口腔溃疡并感染	口腔粘膜溃疡##口腔感染
喉CA	咽喉恶性肿瘤##癌
子宫颈非角化型鳞状细胞癌	子宫颈恶性肿瘤##非角化的鳞状细胞癌
结膜恶性黑色素瘤	结膜恶性肿瘤##黑色素瘤
左丘脑腔隙灶脑白质缺血	脑血管供血不足##腔隙性脑梗死
右小指腱鞘瘤	手部肿瘤
LOA剖一男活婴持续性枕横位	经未特指的剖宫产术分娩
眼袋风湿性拇外翻	下睑袋##足拇外翻
不全流产术后	"未特指的流产,不完全性,无并发症"
眼球挫裂伤	眼球挫伤
腰3/4椎间盘膨出；	腰椎间盘移位
右睾丸回缩	回缩睾丸
双眼角结膜炎	结膜炎
贲门癌术后 进食不畅	贲门术后##贲门恶性肿瘤##进食障碍##癌
尖头并指综合征	阿佩尔综合征[Apert综合征]
骨转移放疗后LuminalBHER2阴性	骨继发恶性肿瘤##转移性肿瘤##恶性肿瘤放疗
双膝骨性关节炎，右侧网球肘	膝骨关节病##肱骨外上髁炎[网球肘]
L1椎体轻度陈旧压缩改变	腰椎压缩性骨折##陈旧性腰椎骨折##腰椎骨折L1
外阴Paget病局部早侵	乳房以外的佩吉特病##外阴恶性肿瘤
颌下皮瘘	皮肤瘘管
乘坐客车时翻车导致头胸腹部被撞击致伤	头部损伤##胸部损伤##腹部损伤
右胫骨下段骨纤维异样增殖症	胫骨纤维结构不良
早孕停育有跌伤史	妊娠状态
发热贫血	发热##贫血
右外耳道耵聍栓塞	外耳道耵聍栓塞
P皮肤淀粉样变	皮肤淀粉样变性
双耳中度听力障碍	听功能障碍
重度呼吸睡眠暂停综合症	睡眠呼吸暂停低通气综合征
少许硬膜下血肿亚急性晚期-慢性期	硬膜下血肿##慢性硬膜下血肿
妊娠39+2周，孕2产1，单活胎，头位，临产	孕39周
鼻腔放化疗后	恶性肿瘤放疗##化学治疗##鼻腔恶性肿瘤
Lutembacher综合征	卢滕巴赫综合征[Lutembacher综合征]
右腿截肢右腿功能障碍	截肢
沸水烫伤8%浅Ⅱ&deg8%颈躯干双上肢	沸水烫伤##多发烫伤
胎儿双肾发育异常	肾发育不全
右侧梨状窝低分化鳞状细胞放化疗后	放射治疗##化学治疗
"脑血管病,骨关节病，肺癌术后"	脑血管病##骨关节病##肺术后##肺恶性肿瘤##癌
甲状旁腺腺病待排	甲状旁腺未特指的疾患
急性胃肠道功能不全	胃肠功能紊乱
左腋窝肉芽组织肿	肉芽肿
多形性未分化肉瘤	肉瘤
新生儿缺血缺氧性脑病并颅内出血	新生儿缺氧缺血性脑病##颅内出血
晶体缺如	无晶状体眼
"左肾透明细胞癌,右侧隐睾下降固定术后"	肾恶性肿瘤##透明细胞癌##隐睾
右大腿内侧根部血管瘤？	血管瘤##血管瘤
妊1产0妊372周臀头位	妊娠状态
尿毒症腹膜透析高血压病冠心病	尿毒症##腹膜透析治疗##高血压##冠状动脉粥样硬化性心脏病
横结肠绒毛状管状腺瘤伴高度粘	横结肠良性肿瘤##管状绒毛状腺瘤
胃角中分化腺癌	胃恶性肿瘤##腺癌
胃角溃疡型中分化腺癌（pT4b	胃恶性肿瘤##腺癌
A45B45楔状缺损C5D4重度磨损	牙齿楔状缺损##牙齿磨损
异位妊娠不除外	体重异常减轻
造瘘口肠粘膜脱出	胃肠道的其他人工造口状态
单眼盲右眼缺如	单眼盲
右踝部感染	感染
右环指甲床和黑母质变病	黑甲和褐甲
肝总管Ca肝内占位	肝外胆管恶性肿瘤##肝占位性病变##癌
右肺鳞癌维持性化学治疗	右肺恶性肿瘤##鳞状细胞癌##恶性肿瘤维持性化学治疗
左颊及右舌粘膜扁平苔藓免疫异常	扁平苔癣##舌扁平苔癣
淤血性脾肿大另送副脾组织	先天性副脾##脾大
G2P1孕36周已产LOA	正常分娩
一过性意识障碍心源性脑源性待除外	一过性意识丧失
双侧乳腺软组织影增多请结合临床病史	乳房诊断性影像异常
右乳增生性炎	乳腺增生##乳腺炎
宫颈CINI后穹窿微浸润	子宫颈上皮瘤样病变[CIN]I级
脾脏符合慢性淤血性脾肿大并副脾组织	先天性副脾##慢性充血性脾大
脑室旁异常信号影MR示	"颅骨和头诊断性影像检查的异常所见,不可归类在他处者"
"乳腺癌,左足背腱鞘囊肿?"	乳腺恶性肿瘤##腱鞘囊肿##足部囊肿##癌
左膝关节腘窝囊肿	膝关节囊肿##腘窝囊肿
内分泌性突眼良性突眼可能性大	眼球突出
右下颌牙龈创伤	口腔和咽喉部损伤
左眼先天性血管异常	血管畸形
右足背皮肤软组织坏死伴缺损	足坏死##皮肤缺损
痔疮伴肛门癣	痔##皮真菌病
双子宫双阴道	双阴道##双子宫
胸12椎体压缩性改变	胸椎压缩性骨折
右腮腺管状腺瘤	腮腺良性肿瘤##管状腺瘤
胎儿异常内脏外翻胸腹壁缺损	胎儿腹裂
慢性粒细胞白血病-急性淋巴细胞白血病变	慢性粒细胞白血病##急性淋巴细胞白血病
右侧腹股沟疝成形术后	单侧腹股沟疝##腹股沟术后
双侧髌骨骨质破坏痛风性	骨质破坏##痛风
鼻咽癌放化疗术后6年复查	鼻咽恶性肿瘤##癌##恶性肿瘤放疗##化学治疗
1型糖尿病性植物神经病变	1型糖尿病性自主神经病
右肺下叶肺占位性病变	肺占位性病变
左膝关节浅表肿物	膝关节肿物
直肠肛门松弛症	直肠脱垂##肛门括约肌松弛
上感（胃肠型 ）	胃肠型感冒
神经原性膀胱(功能不良)	神经源性膀胱
短暂性脑缺血椎基底动脉系统TIA发作	短暂性脑缺血发作##椎-基底动脉供血不全
右手背手掌皮肤撕脱并缺损	手部开放性损伤##皮肤缺损
黑色素肿瘤	黑色素瘤
口底鳞癌放化疗后	口底恶性肿瘤##鳞状细胞癌##恶性肿瘤放疗##化学治疗
右眼突出待查脑外伤后康复期	眼球突出
患儿在玩耍时不慎跌伤	摔伤
心功能不全并肺部感染、梅毒房颤。糖尿病。高血压病	心功能不全##肺部感染##梅毒##心房颤动[心房纤颤]##糖尿病##高血压
右膝ACL胫骨止点陈旧性撕脱性骨折	胫骨骨折
多发性子宫肌瘤富于细胞型	子宫多发性平滑肌瘤##细胞性平滑肌瘤
经典型霍奇金结节硬化型	结节硬化型经典霍奇金淋巴瘤
肛管癌	肛管恶性肿瘤##癌
偶发房性期前收缩[房性早搏]	房性期前收缩[房性早搏]
睾丸精原细胞瘤(C62.101 M90610/3)	睾丸恶性肿瘤##精原细胞瘤
右下肢神经鞘瘤	下肢周围神经和自主神经良性肿瘤##神经鞘瘤
腰34不稳退变	腰椎不稳定##腰椎退行性病变
左下肢周围神经病变腰骶病变	多发性神经病[多发性神经炎/周围神经炎]
咳嗽待查上气道综合症？胃食管反流？	咳嗽##胃食管反流##上气道咳嗽综合征
椎管占位性病变	椎管内占位性病变
喉乳头状瘤术后	乳头状瘤##喉良性肿瘤##喉术后
颅底凹陷继发性颈髓病变	脊髓病
髋骨放疗后	放射治疗
右胸壁脂肪坏死	脂肪坏死
右肺上叶原位癌	肺原位癌
多发淋巴结转移	多部位淋巴结继发恶性肿瘤
停经334周B超提示胎儿后颅凹池扩大	妊娠状态
右卵巢浆液性囊腺癌	卵巢恶性肿瘤##浆液性囊腺癌
高血压病药物控制后血压正常中危	高血压
非胰岛素依赖型糖尿病伴有酮症酸中毒	2型糖尿病性酮症酸中毒
胆汁性肝硬变	胆汁型肝硬化
右侧唇裂	先天性唇裂
浆细胞性白血病	浆细胞白血病
截断术残端特指的并发症	再植和截断术所特有的并发症
停经26周外院彩超胎儿心脏继发隔显示欠清	孕26周
停经312周B超提示胎儿双侧肾窦分离轻度	妊娠状态
考虑左侧颊粘膜扁平苔藓B8过小牙	口腔扁平苔癣##过小牙
双下睑眼袋颞部凹陷右眉下垂	下睑袋
"右侧乳腺粘液癌术后,放射治疗,上感"	乳腺术后##乳腺恶性肿瘤##粘液癌##恶性肿瘤放疗##上呼吸道感染
双叶甲状腺癌	甲状腺恶性肿瘤##癌
(翼腭窝腺样囊性癌)	翼腭窝恶性肿瘤##腺样囊性癌
多发性周围神经病营养障碍型	营养性周围神经病
右第一足趾创伤性足趾切断	单趾切断
青年期心律失常	心律失常
混合型通气功能极重度障碍	通气功能障碍
卵巢恶性混合性上皮肿瘤IIIc期术后	卵巢恶性肿瘤##恶性上皮瘤##卵巢术后
双肺尖部部分纤维硬结灶性质待查	肺诊断性影像异常
颅高压	颅内压增高
右腕皮肤擦伤	腕部擦伤
冠状动脉供血不足;高脂血症;焦虑状态;支架植入术后状态	冠状动脉供血不足##高脂血症##焦虑状态##冠状动脉支架植入术后状态
抗利尿激素分泌不适当综合征	抗利尿激素不恰当分泌综合征
支喘急发期中度发作	支气管哮喘急性发作(中度)
小脑扁桃体下疝伴脊髓空洞	脊髓空洞症##小脑扁桃体下疝畸形[Arnold-Chiari综合征]
右乳腺导管内乳头状肿瘤	乳腺良性肿瘤##导管内乳头状瘤
颈椎间盘C23膨出并椎管C56狭窄	其他的颈椎间盘移位##颈椎管狭窄
扩张型心脏病酒精性心脏病可能性大	扩张性心肌病[充血性心肌病]##酒精性心肌病
左肾切开取石术后	肾结石##肾术后
宫颈癌Ⅰb1期术后第1次化疗后、原发性高血压1级	宫颈术后##子宫颈恶性肿瘤##高血压1级##原发性高血压##癌##恶性肿瘤术后化疗
右足第3趾皮肤部分缺血坏死	下肢皮肤坏死##下肢供血不足
双眼眼袋	下睑袋
血小板减少查因:妊娠相关性	妊娠合并血小板减少
念珠菌性外阴阴N92.600道炎	念球菌性外阴炎
"肺癌 放疗化疗,放射性皮炎,咳嗽,肝功能损害 预防过敏,化疗止吐 维生素缺乏"	肺恶性肿瘤##恶性肿瘤放疗##化学治疗##放射性皮炎##咳嗽##肝功能异常##维生素缺乏##癌
脊髓栓系综合症术后	脊髓栓系综合征
乳腺癌化疗左乳癌术前化疗	乳腺恶性肿瘤##癌##恶性肿瘤术前化疗
双侧乳糜血尿	乳糜尿##血尿
右手拇指指甲剥脱伴甲床破裂	甲脱离
双上肢抖动原因1帕金森综合症其它	不自主运动##帕金森综合征
右胸内肿块	胸腔肿物
右输尿管结石伴右肾积液	肾积水伴输尿管结石
陈旧下壁正后壁右室心肌梗梗死	陈旧性下壁正后壁心肌梗死##陈旧性右心室心肌梗死
鞘膜瘤	神经鞘膜瘤
慢性肺源心脏病右室增大心功4级	慢性肺源性心脏病##心功能IV级(NYHA分级)
手外伤(针刺伤)	手部开放性损伤
皮肤小疖肿治疗后	皮肤疖肿
上呼吸道感染;鼻窦炎?;腹泻	上呼吸道感染##鼻窦炎
肝曲1管状腺瘤部分腺上皮轻－中度异型增生	结肠肝曲良性肿瘤##管状腺瘤
腰椎侧凸	腰椎侧弯
腺病伴导管扩张局部大汗腺化生	乳腺导管扩张症
右下肢骨缺损骨不连	骨折不连接[假关节]##下肢骨折
迁肝	慢性迁延性肝炎
直肠癌新辅助化疗后	直肠恶性肿瘤##化学治疗##癌
紫外线灼伤躯干	"紫外线辐射引起烧伤##躯干未特指的损伤,水平未特指"
原发胃弥漫大B细胞性淋巴瘤	弥漫大B细胞淋巴瘤##胃淋巴瘤
阵发性夜间呼吸困难综合征	阵发性夜间呼吸困难
双侧支气管扩张继发感染	支气管扩张症合并感染
食管中上段鳞癌化疗后	食管中上段恶性肿瘤##鳞状细胞癌##化学治疗
骨关节炎(重度)	重度骨关节病
鼻衄贫血待查：失血性？血小板减少性紫癜	鼻出血[鼻衄]##贫血##血小板减少性紫癜##失血性贫血
右胫后肌腱部分断裂	踝部胫后肌腱损伤
大腿软组织肉瘤	下肢恶性肿瘤##软组织肉瘤
早孕宫内或宫外尚无法确定	妊娠状态
高压电击伤双上肢	电击伤##上肢损伤
肝右叶胆管细胞癌	肝胆管细胞癌##胆管恶性肿瘤
宫颈癌IIB期	子宫颈恶性肿瘤##癌
取出宫内节育器	取出子宫内避孕装置
左跗跖关节劳损	足的其他和未特指部位的扭伤和劳损
上腹部不适伴隐痛	上腹痛
阵发性黑朦待查	黑矇
乳腺增生并导管扩张及纤维腺瘤形成	乳腺增生##乳腺导管扩张症##纤维腺瘤##乳腺良性肿瘤
胸髓病变并不全性截瘫	不完全性瘫痪##截瘫[双下肢瘫痪]
右胫骨下段慢性骨髓炎	胫骨骨髓炎
尺神经病变颈腰椎病取药	颈椎病##腰椎病
右下肢神经、血管损伤	身体未特指部位的神经损伤##身体未特指部位的血管损伤
胃角低分化腺癌术后	胃恶性肿瘤##腺癌##胃术后
踝关节创伤性关节病变	踝关节损伤
慢性阻塞性肺气肿疾病急性加重期	阻塞性肺气肿##慢性阻塞性肺疾病急性加重
急性脑梗死右侧颞顶枕叶急性梗塞灶	脑梗死##多发性脑梗死
子宫颈低分化鳞状细胞癌	子宫颈恶性肿瘤##鳞状细胞癌
腹部刀刺伤	刀刺伤##腹部开放性损伤
颈椎癌	颈椎恶性肿瘤##癌
周围性神经病	多发性神经病[多发性神经炎/周围神经炎]
颈部左侧结节：急性淋巴结炎	急性淋巴结炎
左足底裂伤伴感染	足裂伤##足软组织感染
前列腺癌肺转移	前列腺恶性肿瘤##癌##肺继发恶性肿瘤
2型糖尿病并肾病（尿毒症期）	2型糖尿病肾病V期
停经352周B超提示胎儿持续伸舌状态	妊娠状态
子宫腺肌症合并子宫肌瘤	子宫肌腺症##子宫平滑肌瘤
右手第5近节指骨骨折复查	指骨近节骨折
脚软食欲差	食欲不振
舌部麻木原因待查躯体形式障碍可能性大	躯体症状障碍
右侧眼睑皮样瘤	眼睑良性肿瘤
霍奇金［何杰金］病未特指C819	未特指的霍奇金病
腰45右侧小关节异常改变请结合定位检查	腰椎小关节紊乱
冠心病心绞痛型缺血性心肌病	冠状动脉粥样硬化性心脏病##心绞痛##缺血性心肌病
右耳高频轻度感音神经性听力损失	感音神经性聋##高频率耳聋
摔倒于乱石堆上致鼻部上唇软组织不完全撕脱	跌倒##鼻部开放性损伤##唇部开放性损伤
23埋伏阻生	埋伏牙##阻生牙
中度呼吸睡眠暂停综合征	睡眠呼吸暂停低通气综合征
左手腕部扭转	腕关节扭伤
左乳癌术后伴双肺、多发骨转移综	乳腺术后##癌##乳腺恶性肿瘤##肺继发恶性肿瘤##骨继发恶性肿瘤##转移性癌
颈部刀刺伤	颈部开放性损伤##刀刺伤
胃角管状腺瘤	胃良性肿瘤##管状腺瘤
chiari畸型I型并骨髓空洞	小脑扁桃体下疝畸形[Arnold-Chiari综合征]##脊髓空洞症
头皮鳞癌	鳞状细胞癌##头皮恶性肿瘤
表皮葡萄球菌	葡萄球菌感染
右拇指甲床示指皮肤撕脱缺损	拇指开放性损伤伴指甲损伤##手指开放性损伤##皮肤缺损
静脉特指疾患双侧卵巢静脉迂曲扩张	静脉其他特指的疾患
(慢性)鼻窦炎/声带息肉	慢性鼻窦炎##声带息肉
共同性外斜视(术后)	眼术后##共同性内斜视
退变的骨组织伴灶性坏死及纤维化	骨坏死
右肺鳞癌Ⅲ期	右肺恶性肿瘤##鳞状细胞癌
双下肢动脉硬化伴散在斑块	肢体动脉硬化
系统性红斑狼疮伴干燥综合征	系统性红斑狼疮##干燥综合征[舍格伦综合征]
孕292周防婴儿佝偻病妊娠期补钙	妊娠状态
结肠梗阴小肠功能缺失完全不能进食	结肠梗阻##肠功能紊乱
乙状结肠癌（pT3N2aMx）	乙状结肠恶性肿瘤##癌##淋巴结继发恶性肿瘤
盆腔静脉瘀血症轻度	盆腔静脉充盈综合征
异位ACTH综合征放疗后	异位促肾上腺皮质激素综合征##放射治疗
大疱表皮样癣性药疹	莱尔综合征[lyell综合征]
慢性糜烂性胃炎	糜烂性胃炎
结肠癌pT4N0M0	结肠恶性肿瘤##癌
右乳纤维囊性乳腺病并纤维腺瘤	乳腺良性肿瘤##纤维腺瘤##乳房纤维囊性乳腺病
右肾透明癌	肾恶性肿瘤##透明细胞癌
第一腰椎压缩性骨折	腰椎压缩性骨折
双下肢感觉肌力异常大小便障碍	排便困难##排尿困难
慢性肾功能衰竭(微量蛋白尿)	慢性肾衰竭##蛋白尿
脑胶质瘤术后复发二次术后WHOⅣ级	脑术后##胶质神经瘤
右手小指伸肌腱扩张部部分撕裂	手部韧带断裂
乙状结肠降结肠交界处管状腺瘤	结肠良性肿瘤##管状腺瘤
自发性颅内低压心境障碍	心境[情感]障碍##自发性低颅压综合征[原发性低颅压]
食管浅表溃疡型中分化鳞状细胞癌	食管恶性肿瘤##鳞状细胞癌
"宫颈鳞癌IIb放化疗,化疗止吐保心保肝脱水利尿,消化不良，食欲减退，咳嗽咳痰"	子宫颈恶性肿瘤##鳞状细胞癌##放射治疗##化学治疗##消化不良##食欲不振##咳嗽
冠心病--心绞痛心功能2级	冠状动脉粥样硬化性心脏病##心绞痛##心功能Ⅱ级(NYHA分级)
"急性扁桃体炎,哮喘"	急性扁桃体炎##支气管哮喘
右侧附件异常回声待查血HE4升高原因待查	肿瘤标记物升高
被人击打致伤	被别人殴打、踢、拧、咬或抓伤
孕1产0宫内妊娠37周单活胎LOA	孕37周
右肾盂输尿管炎性病变	肾盂肾炎##输尿管炎
脾破裂出血	脾破裂##脾出血
"肱骨干骨折(左侧,术后)"	肱骨干骨折##骨折术后
乳腺非霍奇金淋巴瘤	乳腺淋巴瘤##非霍奇金淋巴瘤
G6PD缺乏并溶血	葡萄糖-6-磷酸脱氢酶缺乏性贫血
右面部红肿痒疑过敏	过敏反应
宫颈上皮异常细胞CINI	子宫颈上皮瘤样病变[CIN]I级
HIV病毒携带者实验确认报告阳性	其他传染病病原携带者##人类免疫缺陷病毒阳性[HIV阳性]
特指器官后天性缺失左手第2	后天性单侧手指缺失
椎基底动脉TIA	椎-基底动脉供血不全##短暂性脑缺血发作
颈腰椎病股动静脉斑块形成	颈椎病##腰椎病
腹膜癌术后检查	腹膜恶性肿瘤##癌##恶性肿瘤手术后的随诊检查
右卵巢高级别浆液性癌IIA期	卵巢恶性肿瘤##浆液性癌
先天喉软骨发育不良	先天性喉发育不全
T细胞淋巴组织增殖性疾病1级增生性	淋巴细胞增殖性疾病
食管狭窄(食管恶性肿瘤)	食管狭窄##食管恶性肿瘤
脐部窦道	脐窦
待查重叠重合征低钾血征	低钾血症##重叠综合征
L2右侧横突锥弓及棘突根部骨质破坏	骨质破坏
非霍奇金淋巴瘤Ⅲ期A 弥漫大B细胞淋巴瘤 检查	弥漫大B细胞淋巴瘤
加速性性交界性逸搏心律	结性逸搏
胎膜及脐带未见明显异常胎盘局部梗死	胎盘梗死
息肉切除组织123均为绒毛-管状腺瘤	管状绒毛状腺瘤
细菌口腔炎	口炎##细菌感染
脑血管病(脑供血不足)	脑血管供血不足##脑血管病
电弧烧伤面颈	面部烧伤##颈部烧伤##电流引起烧伤
右下肢麻木原因腰椎病	腰椎病
下肢淤血性皮炎双侧	皮炎
外阴鳞状细胞癌化疗后	外阴恶性肿瘤##鳞状细胞癌##化学治疗
肝硬化肝功能代偿期	肝硬化
根治性膀胱切除术后原位膀胱	膀胱术后
变态反应性肠病	变态反应
癫痫;缺血性脑血管病;颈动脉斑块;高胆固醇血症;高脂血症	癫痫##缺血性脑血管病##高胆固醇血症##高脂血症
左下颌骨造釉细胞瘤左颌下淋巴结	面骨良性肿瘤##成釉细胞瘤
先天性脑垂体发育不良	垂体发育不良
颅内多发大动脉重度狭窄双侧椎动脉基底动脉	动脉狭窄##椎动脉狭窄##基底动脉狭窄
颈髓脱髓鞘改变	脱髓鞘性脊髓病
心肌酶升高	心肌酶谱异常
左侧输尿管切开取石术后	输尿管结石##输尿管术后
左拇指腱鞘狭窄	狭窄性腱鞘炎
溃疡型脉管腺癌	腺癌
高直后位难产	高直后位引起的梗阻性分娩
前列腺癌综合治疗后	前列腺恶性肿瘤##癌
左侧肾盂癌	肾盂恶性肿瘤##癌
A2完全脱落B1牙冠部分缺损	牙体缺损##牙脱位
喉咽癌综合治疗后	喉咽恶性肿瘤##癌
药物诱导性自身免疫性肝炎	自身免疫性肝炎
阴道真菌月经不调	月经紊乱##真菌性阴道炎
十二指肠乳头中分化腺癌	十二指肠恶性肿瘤##腺癌
女性右侧乳腺癌	乳腺恶性肿瘤##癌
继发性不孕子宫输卵管碘油造影预防抗炎	继发不孕
右下肺癌、肺结核（-）	右肺下叶恶性肿瘤##癌
甲型流感病毒肺炎	甲型流感##已知病毒的流感性肺炎
不慎从15m高处坠落伤及头部	头部损伤##自高处坠落
腹水查因:结核性腹膜炎	腹水##结核性腹膜炎
并指指融合	并指
妊5产2妊326周臀头位	妊娠状态
"食管胸中段癌,化疗呕吐,反流性食管炎,白细胞低"	食管胸中段恶性肿瘤##癌##化疗药物反应##呕吐##反流性食管炎##白细胞减少
多脏器功能不全肝肾凝血功能不全	多脏器功能障碍综合征[MODS]##凝血功能障碍
急性脑梗死右侧额叶顶叶颞叶梗死	脑梗死##多发性脑梗死
心功能Ⅰ级(KILLIP)	KillipI级
急性迷路炎或前庭麻痹症	迷路炎[内耳炎]##前庭神经炎
猩红热心肌炎	猩红热##心肌炎
左上臂腋窝肿物待查	上肢肿物##腋窝占位
胸片提示：右上肺可疑结节	肺占位性病变
左脚皮瓣撕裂伤，全身多处皮肤擦伤	足部软组织撕脱伤##多处皮肤浅表擦伤
口腔鳞癌	口腔恶性肿瘤##鳞状细胞癌
胎儿染色体发育异常	先天性胎儿染色体异常
宫颈上皮内病变CINI	子宫颈上皮瘤样病变[CIN]I级
右足开水烫伤	沸水烫伤##足部烫伤
左眼软组织挫伤	眼睑及眼周区挫伤
宫颈腺癌放化疗后	子宫颈恶性肿瘤##腺癌##恶性肿瘤放疗##化学治疗
外阴BOWEN’S病宫颈CIN3级	鲍恩病##外阴恶性肿瘤##子宫颈上皮内瘤变III级[CINIII级]
胆道高位梗阻考虑恶性	胆道恶性肿瘤
脾脏瘀血性脾肿大	脾大
双眼轻度白内障	白内障
宫颈鳞癌ⅢB期放化疗后	子宫颈恶性肿瘤##鳞状细胞癌##化学治疗##恶性肿瘤放疗
胰头肿物	胰腺肿物
胆总管囊肿(术后)	胆总管囊肿##胆道术后
垂体Rathke裂隙	先天性垂体发育异常
右中下肺炎	肺炎
主动脉瓣及二尖瓣退行性	二尖瓣退行性变##退行性主动脉瓣疾患
双子宫双宫颈伴双阴道	双子宫双子宫颈双阴道
右上肺磨玻璃小结节	肺占位性病变
前胸浅表肿物	胸壁肿物
脑内多发性缺血性脱髓鞘	脱髓鞘病
脐部瘘管	脐瘘
上颌骨腺样囊性癌术后，多发腰椎转移	上颌骨恶性肿瘤##O##腺样囊性癌##转移性腺样囊性癌
(宫颈CINI)	子宫颈上皮瘤样病变[CIN]I级
供血不足及脑功能下降	脑血管供血不足
高空坠落伤1周右腕骨折左肩胛骨骨折头外伤左面部外伤	自高处坠落##肩胛骨骨折##头部损伤##面部损伤##腕关节骨折
双手晨僵功能障碍	僵
肺部纤维灶右上肺斑片影	肺部阴影##肺诊断性影像异常
房间隔膨出卵园孔未闭	卵圆孔未闭##先天性房间隔膨出瘤
左距骨骰骨踝和足韧带破裂伴骨缺损	足部韧带断裂##下肢韧带损伤
肺恶性肿瘤;封管;深静脉置管;换药	肺恶性肿瘤
腕和手水平肌肉和肌腱损伤	在腕和手水平的未特指肌肉和肌腱的损伤
缺损部分性肺静脉异位引流心上型	部分型肺静脉异位引流
膀胱颈糜烂	膀胱未特指的疾患
多发性骨髓瘤(IGG KAPPA型)ISS分期I期 D-S分期IIIA期	多发性骨髓瘤(IgGк型)##多发性骨髓瘤(ISS分期I期)##多发性骨髓瘤(DS分期III期)
左腘肌腱止点撕脱性骨折	胫骨骨折
腰椎退病侧弯	腰椎退行性病变##腰椎侧弯
颅咽管瘤切除术后	颅咽管瘤
下肢动脉硬化症	肢体动脉硬化
左侧硬腭静脉畸形	周围静脉畸形
非酒精性脂肪肝病	脂肪肝
6胎儿溶血	胎儿和新生儿未特指的溶血性疾病
降结肠腺癌	降结肠恶性肿瘤##腺癌
内分泌胰腺癌	内分泌胰腺恶性肿瘤##癌
偏执观念	偏执性精神障碍
右腹股沟伤口愈合不良	腹股沟损伤##开放性损伤愈合不良
视网膜修复术后	眼术后
交界性逸搏伴完全性右束支阻滞	结性逸搏##完全性右束支传导阻滞
宫颈中分化鳞癌免疫治疗	子宫颈恶性肿瘤##鳞状细胞癌##恶性肿瘤免疫治疗
浸润型中分化腺癌	腺癌
肝酶肌酶增高待查	血清肌酶异常##转氨酶升高
G周宫内妊娠引产后	引产
下颌牙列缺损B34C45楔状缺损	牙齿楔状缺损##牙列缺损
胎盘异常帆状胎盘及副胎盘	妊娠合并副胎盘##妊娠合并帆状胎盘
热液烫伤25%面部躯干左上肢双下肢	多发烫伤
胃癌化疗后	胃恶性肿瘤##化学治疗##癌
慢性鼻-鼻窦炎伴右鼻息肉	慢性鼻窦炎##鼻息肉
膀胱mt术后	膀胱恶性肿瘤##膀胱术后
右腕狗抓伤	被狗抓伤##腕部开放性损伤
腰3椎体陈旧性骨折	陈旧性腰椎骨折##腰椎骨折L3
急性坏疽性阑尾炎并周围脓肿	急性坏疽性阑尾炎##阑尾周围脓肿
右枕叶占位	脑占位性病变
低磷抗D性软骨病转归其他	低磷血症##抗维生素D性佝偻病
上呼吸道的疾病该钙缺乏	其他特指的上呼吸道疾病##钙代谢紊乱
胃食管粘膜异型增生	食管粘膜不典型增生##胃粘膜不典型增生
盲肠绒毛状管状腺瘤可能	盲肠良性肿瘤##管状绒毛状腺瘤
脾稍增大副脾	先天性副脾##脾大
前列腺组织内腺癌浸润	前列腺恶性肿瘤##腺癌
脑膜动态未知肿瘤	脑膜动态未定或动态未知的肿瘤
新生儿基底节阴影待查	头部诊断性检查异常
特指胎盘疾病组织残留	胎盘部分残留不伴出血##未特指的胎盘疾患
右眼睑皮肤全层裂伤	眼睑裂伤
免疫相关不良妊娠	妊娠状态
左下肢撞伤	"下肢未特指的损伤,水平未特指"
两侧乳腺增生结节	乳腺增生##乳房结节
"右肺癌,肝脏多发弥漫性结节,双侧肾上腺占位胃溃疡胃酸多,多发骨转移 中重度疼痛,维生素缺乏 咳嗽,化疗止吐 脑转移"	右肺恶性肿瘤##肝占位性病变##胃溃疡##胃酸分泌过多##骨继发恶性肿瘤##疼痛##维生素缺乏##咳嗽##脑继发恶性肿瘤##化学治疗##肾上腺占位
血行播散型肺结核	肺结核
左回旋支粥样硬化伴轻度狭窄	冠状动脉粥样硬化##冠状动脉狭窄
乳腺纤维腺病	乳腺良性肿瘤##纤维腺瘤
右大腿血管畸形	下肢血管畸形
舌下神经瘤	神经瘤##舌下神经良性肿瘤
海马变性硬化	大脑变性##海马硬化[颞叶内侧硬化]
L32腰椎体终板炎L	骨软骨炎
左足第一足趾远节趾骨撕脱性骨折伴脱位	趾骨骨折##趾间关节脱位
原发性肝癌化疗	肝恶性肿瘤##化学治疗##癌
慢性浅表性胃炎伴灶性肠上皮化生	慢性浅表性胃炎##肠上皮化生
左髋股骨囊性变	股骨骨囊肿##髋部囊肿
左踝骨折内固定术后	踝骨骨折##骨折术后
食管颈段鳞状细胞癌	食管颈部恶性肿瘤##鳞状细胞癌
急性支气管炎/骨关节病/睡眠障碍	急性支气管炎##骨关节病##睡眠障碍
软骨发育不全	软骨发育不全
胆囊结石取石术后	胆囊结石##胆囊术后
"脑卒中后遗症,抑郁症,原发性高血压3级极高危"	抑郁症
黏膜组织慢性炎伴淋巴组织增生	淋巴组织增生##淋巴组织增生病
第1-2腰椎骨折	腰椎骨折L1##腰椎骨折L2
肛裂并感染	肛裂##感染
脑血栓	脑血栓形成
右肺MT伴肺转移？	右肺恶性肿瘤##肺继发恶性肿瘤##转移性肿瘤
结肠腺癌	结肠恶性肿瘤##腺癌
胸腹部及会阴部烫伤　Ⅰ°-浅Ⅱ° TBSA 6%	会阴烫伤
指甲增厚查因1甲藓2微量元素缺乏	甲癣##微量元素缺乏症
脊椎多发骨破坏	骨质破坏
腰4、5椎体不稳	腰椎不稳定
痤疮样疹激素依赖性＋脂溢性	痤疮样皮疹##激素依赖性皮炎##脂溢性皮炎
药疹待排病毒疹	药物性皮炎[药疹]##病毒性皮疹
特指单个手指部分或完全切断右手中指缺如	其他单个手指创伤性切断(完全)(部分)##创伤性手指缺如
双眼局限性脉络膜视网膜色素上皮病变	分类于他处的疾病引起的其他脉络膜视网膜疾患
卵巢浆液性乳头状癌	卵巢恶性肿瘤##浆液性表面乳头状癌
腰椎侧凸腰椎分隔不全	腰椎侧弯
子宫肌瘤雕核术后	子宫术后##子宫平滑肌瘤
（左肺）低分化腺癌，符合低分化腺癌，含鳞状细胞癌成分	肺恶性肿瘤##腺癌##鳞状细胞癌
鼻咽癌放疗23次	鼻咽恶性肿瘤##恶性肿瘤放疗##癌
慢性阻塞性肺疾病伴肺部感染	慢性阻塞性肺疾病##肺部感染
迷路震荡	内耳未特指的疾病
左骶髂骨巨细胞瘤	骨巨细胞瘤##骨盆部肿瘤
左心室心肌先天性发育不良	左心发育不良综合征
多发腔隙性梗死脑干双侧基底节及放射冠区	腔隙性脑梗死##基底节脑梗死##多发性脑梗死
会阴部瘢痕挛缩畸形	瘢痕挛缩##会阴瘢痕
L1-2椎管内神经鞘瘤	神经鞘瘤##椎管内良性肿瘤
非创伤性颅内出血后遗症	非创伤性颅内出血##颅内出血后遗症
臀部皮脂腺囊肿感染	皮脂腺囊肿##感染
AS致双髋强直破坏	强直性脊柱炎
停经344周B超提示胎儿脑中线无回声区	妊娠状态
喉部新生物Ⅱ度呼吸不畅	喉息肉##呼吸困难
乳癌复诊	乳腺恶性肿瘤##癌
低鼻眼袋成形	下睑袋
乳腺癌(左侧)	乳腺恶性肿瘤##癌
继发性自身免疫性甲状腺病甲功正常期	其他特指的甲状腺疾患
糖尿病酮症酸中毒	糖尿病性酮症酸中毒
肺感染(发烧)	肺部感染##发热
阴道鳞癌Ⅰ期放化疗后	阴道恶性肿瘤##鳞状细胞癌##恶性肿瘤放疗##化学治疗
2型糖尿病伴有酮症酸中毒	2型糖尿病性酮症酸中毒
弥漫性肺纤维化	肺纤维化
咳嗽，肝肾阴虚，	咳嗽
甲状腺低分化癌	甲状腺恶性肿瘤##癌
直肠乙状结肠管状腺瘤建议定期随诊复查	直肠良性肿瘤##乙状结肠良性肿瘤##管状腺瘤
右膝骨性关节炎并半月板撕裂	单侧膝关节骨性关节病##膝半月板撕裂
右屈肘总肌腱止点撕脱性骨折	肘关节骨折
先心病房缺封堵术后；高血压	房间隔缺损##高血压##心脏术后
产伤性Ⅰ度会阴裂伤	分娩伴会阴裂伤I度
侵犯胸壁2周期化疗后	化学治疗
右卵巢子宫内膜样腺癌维持性化学治疗	卵巢恶性肿瘤##恶性肿瘤维持性化学治疗##子宫内膜样腺癌
右室双出口	右心室双出口
糖尿病肾病(肾功能不全期)	糖尿病性肾病##肾功能不全
风湿性瓣膜病	风湿性心脏病##心脏瓣膜病
风心病换瓣术后	具有其他心脏瓣膜置换##风湿性心脏病
右足234趾外伤性缺血坏死	足趾损伤##足坏死
左侧基底节血管性病变，静脉畸形伴海绵状血管瘤?	基底节病变##海绵状血管瘤
颅内多发脑缺血脑白质脱髓鞘改变	脱髓鞘性白质脑病##脑血管供血不足
亚甲炎(?)	亚急性甲状腺炎[德奎尔万甲状腺炎]
肠易激惹综合症	肠易激综合征
"肱骨大结节骨折(左侧,术后)"	肱骨大结节骨折##骨折术后
右颞部皮肤擦伤	头皮擦伤
脑小血管病糖尿病性感觉运动性周围神经病变	糖尿病性周围神经病##脑血管病
子宫平滑肌瘤，伴腺瘤样瘤性平滑肌瘤和腺肌症；增生期样子宫内膜；慢性宫颈炎。	子宫平滑肌瘤##子宫平滑肌瘤##子宫肌腺症##子宫内膜增生##慢性子宫颈炎
颈胸背部广泛皮下气肿并纵膈积气	纵隔气肿
"头晕,高血压,糖尿病；脑出血恢复期"	头晕##高血压##糖尿病##脑出血恢复期
送检左舌背纤维脂肪组织增生伴表面鳞状	舌鳞状上皮增生
合并骶丛部分性根性损害	腰骶丛损害
肾上腺增生引起的原发性醛固酮过多症	肾上腺增生##原发性醛固酮增多症[低肾素性醛固酮增多症]
盆腔炎慢性	盆腔炎
阿米巴病	肠阿米巴病
右侧输尿管切开取石术后	输尿管结石##输尿管术后
粘连性不全性肠梗	不完全性肠梗阻##粘连性肠梗阻
肺鳞状细胞癌	肺恶性肿瘤##鳞状细胞癌
右颊粘膜挫裂伤	颊挫伤
右侧胫骨骨缺损及骨不连	胫骨骨折不连接
右侧胸水原因待查	胸腔积液
右肘部皮擦伤	上肢浅表擦伤
右肺上叶小细胞癌维持性化学治疗	右肺上叶恶性肿瘤##小细胞癌##恶性肿瘤维持性化学治疗
左肩关节破裂	肩部损伤
糖尿病肾病（原肾）	糖尿病性肾病
双肺多发转移骨转移不除外	肺继发恶性肿瘤##骨继发恶性肿瘤##转移性肿瘤
HP感染慢性胃炎反流性食管炎	幽门螺旋杆菌感染##反流性食管炎##慢性胃炎
左额硬膜下血肿非创伤性	非创伤性硬脑膜下血肿
帽状腱膜下血肿	头皮血肿
子宫腔赘生物	子宫息肉
喉癌全程放疗后	喉恶性肿瘤##癌##恶性肿瘤放疗
右侧腹部刀捅伤	刀刺伤##腹部开放性损伤
特指垂体疾患Rathke裂隙	其他垂体疾患
腰3-5间盘膨出骶管巨大囊肿	其他特指的椎间盘移位##椎管囊肿
双肺间质性改变特发性肺纤维化可能性大	间质性肺病##肺纤维化
上呼吸道感染;乳腺癌	上呼吸道感染##乳腺恶性肿瘤##癌
前列腺肥大不排除恶性可能	前列腺增生##前列腺恶性肿瘤
双眼VKH综合征原田氏病	Vogt-小柳原田综合征
口干苦，便秘气阴两虚证	口干##便秘
恶性胸水增大	恶性胸腔积液
获得性凝血功能障碍维生素K依赖性	凝血功能障碍##维生素K缺乏
子宫内膜癌Ⅱ期术后Ⅱ期 T2N0M0	子宫术后##子宫内膜恶性肿瘤##癌
MODS肝肾心功能损害DIC	多脏器功能障碍综合征[MODS]##弥散性血管内凝血
双侧股骨发育畸形	先天性股骨发育不良
宫颈浸润型低分化鳞状细胞癌	子宫颈恶性肿瘤##鳞状细胞癌
慢性肾脏病矿物质及骨代谢异常	慢性肾病##矿物质代谢紊乱
淋巴结内淋巴上皮样癌	未特指的淋巴结恶性肿瘤##癌
双侧髂动脉右侧股浅动脉支架植入术	血管支架植入术后状态
急性脑梗塞桥脑右颞急性腔隙性梗塞	脑梗死##多发性脑梗死##腔隙性脑梗死
急性普通B淋巴细胞白血病（L2型，中危，缓解期）	急性淋巴细胞白血病L2##急性淋巴细胞白血病L2型##B细胞急性淋巴细胞白血病
右上肺低分化神经内分泌癌	右肺上叶恶性肿瘤##神经内分泌癌
左腋下皮脂腺囊肿	皮脂腺囊肿
残胃癌并梗阻	残胃恶性肿瘤##癌
胃体癌	胃体恶性肿瘤##癌
感染性脑病	中枢神经系统感染
咀嚼无力吞咽无力功能性疾病可能性大	吞咽障碍
双输卵管结扎术后	结扎输卵管绝育
逸搏心律	心律失常
"左肺周围型小细胞肺癌广泛期放化疗 ,胃镜检查 置管,无法进食"	左肺恶性肿瘤##小细胞癌##放射治疗##化学治疗
糖尿病(企业慢病)	糖尿病
双下肢大隐筋脉曲张	大隐静脉曲张
右上睑睑缘炎	睑缘炎
腹部枪击伤术后	枪击伤##腹部开放性损伤
椎体压缩骨折术后	脊柱骨折##骨折术后
亚临床型甲状腺功能亢进症	亚临床甲状腺功能亢进
发热伴皮疹原因待查	发热##皮疹
前降支中段心肌桥第一对角支中度狭窄	冠状动脉肌桥##冠状动脉狭窄
糖尿病肾病;反流性食管炎	糖尿病性肾病##反流性食管炎
颈段食管癌cT3N0M0 放化疗	食管颈部恶性肿瘤##恶性肿瘤放疗##化学治疗##癌
泌尿系统继发癌	泌尿系统继发恶性肿瘤##继发性癌
停经34周B超提示胎儿胼胝体显示不清	孕34周
头痛呕吐原因待查	头痛##呕吐
左尺骨鹰嘴前方撕裂性骨折陈旧性	陈旧性尺骨骨折
右食指近指间关节囊破裂伴部分骨质缺损	手指损伤
血吸虫肝	血吸虫病
HCC介入治疗后；HCC	肝细胞癌##肝细胞癌##恶性肿瘤介入治疗
结肠粘膜低级别管状腺瘤粟粒大2块	结肠良性肿瘤##管状腺瘤
腰椎病理性压缩骨折	腰椎压缩性骨折##病理性骨折
皮肤异色病样扁平苔藓LE	扁平苔癣##红斑狼疮
左甲癌术后	甲状腺恶性肿瘤##癌##甲状腺术后
肝内团片状低密度影待查CA其他	肝恶性肿瘤##癌
右尺骨冠突鹰嘴撕脱性骨折	尺骨鹰嘴骨折##尺骨冠突骨折
心功能不全急性心肌损伤	心功能不全##心肌损害
垂体大腺瘤	垂体良性肿瘤##垂体腺瘤
情绪障碍脑白质脱髓鞘	脱髓鞘性白质脑病##心境[情感]障碍
子宫颈鳞癌IIB期放化疗后	子宫颈恶性肿瘤##鳞状细胞癌##恶性肿瘤放疗##化学治疗
扩张型心肌病心律失常：持续性室速慢性心功能不全NYHAIII-IV级	扩张性心肌病[充血性心肌病]##心律失常##持续性室性心动过速##心功能III级(NYHA分级)##心功能IV级(NYHA分级)
黏膜白斑	"白斑病,不可归类在他处者"
慢性免疫介导性周围神经病变	免疫相关性周围神经病
腹腔镜保胆取石术后	胆囊术后##胆石症
腰椎间盘切除术椎间植骨融合内	腰椎术后
肺血管畸形	肺血管畸形
口内溃疡	口腔粘膜溃疡
肝硬化伴脾功能亢进	肝硬化##脾功能亢进
免疫功能低先心病卵圆孔未闭	先天性心脏病##卵圆孔未闭
胃肠道功能障碍	胃肠功能紊乱
OA磷脂综合征	骨关节病
右拇短伸肌腱断裂	手部肌肉肌腱断裂
右室双出口术后	右心室双出口
双膝软组织挫擦伤	膝部挫伤
脐尿管囊肿伴感染	先天性脐尿管囊肿##感染
左前臂KT综合征	血管骨肥大综合征[Klippel-Trenaunay-Weber综合征]
急性脑血管病((脑梗死))	脑梗死##脑血管病
眼裂小待查	睑裂狭小
鞍区占位病变	颅内占位性病变
右手中指血管球瘤	肢端血管瘤##血管球瘤
肩关节恶性肿瘤，左，滑膜肉瘤，术后	肩关节恶性肿瘤##滑膜肉瘤
双侧卵巢高级别浆液性腺癌	卵巢恶性肿瘤##浆液性腺癌
食管胸中段中分化鳞癌（术后）	食管术后##食管胸中段恶性肿瘤##鳞状细胞癌
RHCC晚期	肝细胞癌
L5椎体压缩性骨折	腰椎压缩性骨折##腰椎骨折L5
分离性障碍可能性大脊髓血管病变不除外	分离[转换]性障碍##血管性脊髓病
降结肠高分化腺癌根治术后I期PT2N0M0	腺癌##降结肠恶性肿瘤##结肠术后
前列腺癌肺M	前列腺恶性肿瘤##肺继发恶性肿瘤##癌##转移性癌
颌下皮肤裂伤	颞颌下区开放性损伤
足背动脉闭塞	足部动脉闭塞
白内障行动不便	白内障
右乳房皮肤Paget's病	乳腺恶性肿瘤##乳房佩吉特病
"右肺小结节,乳腺癌"	肺占位性病变##乳腺恶性肿瘤##癌
双侧放射冠区及右侧枕部脱髓鞘改变	脱髓鞘性脑病
头面部背部软组织挫裂伤	面部软组织挫伤##背部挫伤##头皮挫伤
咳嗽（肺气不宣）	咳嗽
左上尺桡关节先天融合症	先天性尺桡骨融合
胰腺体部脂肪浸润或小囊肿可能	胰腺囊肿
双眼小柳－原田氏综合征	Vogt-小柳原田综合征
头部、左膝外伤	"下肢未特指的损伤,水平未特指##头部损伤"
双侧跟腱类风湿性腱膜炎	跟腱炎##类风湿性关节炎
肝左叶病灶介入治疗后肝右叶病灶射频治疗后	射频消融术后
右坐骨异常信号囊肿可能	骨囊肿
左颈部淋巴结Castleman病浆细胞型	Castleman病
创伤性硬脑膜下血肿慢性或亚急性	慢性创伤性硬脑膜下血肿##亚急性创伤性硬脑膜下血肿
右眼黄斑劈裂左眼高眼压	视网膜劈裂症##高眼压症
浮肿原因待查慢性肾脏病可能	慢性肾病##水肿
胸中下段食管鳞状细胞癌	食管胸下段恶性肿瘤##鳞状细胞癌
十二指肠壶腹癌IV期	法特壶腹恶性肿瘤##癌
左足舟状骨跟骨骰骨背侧撕脱性骨折	足舟骨骨折##骰骨骨折##跟骨骨折
双肺内散在斑片样影考虑间质性改变请随诊	肺部阴影
阴道异物继发感染	阴道内异物##感染
膀胱乳头状尿路上皮癌	膀胱恶性肿瘤##乳头状尿路上皮癌
髋关节挛缩畸形	髋关节僵硬
坏疽性胆囊炎	急性坏疽性胆囊炎
双侧颈内动脉及椎动脉多发钙斑形成	颈内动脉斑块##椎动脉斑块
阴囊炎性破溃	阴囊炎##阴囊开放性损伤
病毒性肝乙型慢性重度	病毒性肝炎乙型慢性重型
慢性移植物抗宿主反应病口腔眼肝脏皮肤	慢性移植物抗宿主病
腿肿	下肢肿胀
直肠绒毛-管状腺瘤	管状绒毛状腺瘤##直肠良性肿瘤
肝病综合征（巨细胞病毒感染）	未特指的肝病##巨细胞病毒感染
右膝关节面软骨损伤	膝关节损伤
静脉特指疾患右上腔静脉狭窄	静脉其他特指的疾患##上腔静脉狭窄
右手掌软组织损伤	手部损伤
子宫内膜癌糖尿病 高血压	子宫内膜恶性肿瘤##癌##糖尿病##高血压
右乳浸润性导管癌伴肝脏转移	乳腺恶性肿瘤##肝继发恶性肿瘤##浸润性导管癌##转移性导管癌
升结肠管状腺瘤降结肠直肠管状腺瘤	升结肠良性肿瘤##降结肠良性肿瘤##直肠良性肿瘤##管状腺瘤
孕31周、妊娠糖尿病？	妊娠合并糖尿病##孕31周
右上叶GGO不除外恶性	肺部阴影##肺恶性肿瘤
脑血管病; 高脂血症;免疫功能低下 支气管炎	脑血管病##高脂血症##支气管炎
宫颈鳞癌放化疗后反复	子宫颈恶性肿瘤##鳞状细胞癌##化学治疗##恶性肿瘤放疗
泌尿道梗阻(待查)	尿路梗阻
右手并指术后、上呼吸道感染	并指##上呼吸道感染
脑动静脉畸形栓塞术后	脑动静脉畸形##动静脉畸形栓塞术后
右肺上叶浸润性腺癌维持性化学治疗	右肺上叶恶性肿瘤##恶性肿瘤维持性化学治疗##癌
复发性弥漫大B细胞淋巴瘤	弥漫大B细胞淋巴瘤##恶性肿瘤复发
"右乳癌术后 右上纵隔肿物,准备穿刺,气管镜检查,预防出血"	乳腺术后##乳腺恶性肿瘤##纵隔肿物##癌
高胆固醇血症/上感	高胆固醇血症##上呼吸道感染
移植皮瓣坏死右足底	足坏死
右胫骨中下端骨折畸形愈合	胫骨干骨折
双手骨关节炎	骨关节病
切口脂肪液化	手术后切口脂肪液化
直肠活检管状腺瘤并增生性息肉建议定期复查	直肠良性肿瘤##管状腺瘤##直肠息肉
单角子宫	单角子宫
脂肪肝，乳腺癌术后 化疗 严重骨质蔬松症	脂肪肝##乳腺术后##乳腺恶性肿瘤##癌##重度骨质疏松##恶性肿瘤术后化疗
痔(出血)	痔##出血
小脑腔隙性梗死	腔隙性脑梗死##小脑梗死
左大腿被他人踢伤	大腿损伤##被别人殴打、踢、拧、咬或抓伤
先天性胼胝体发育不良	胼胝体发育不全
座疮伴睡眠不良	痤疮##睡眠障碍
睾丸恶性淋巴瘤	睾丸淋巴瘤##恶性淋巴瘤
左肺腺癌Ⅳ期 cT1N3M1 化疗	左肺恶性肿瘤##腺癌##化学治疗##淋巴结继发恶性肿瘤
低白蛋白血症持续透析状态	低蛋白血症##肾脏透析状态
胆囊管占位	胆管占位性病变
左侧胫骨远端外侧踝及腓骨撕脱性骨折	胫骨骨折伴踝骨折##腓骨骨折
先天性心脏病合并妊娠	妊娠合并先天性心脏病
右肾盂及输尿管扩张积水	肾盂扩张##输尿管扩张##肾积水##输尿管积水
溶血状态遗传性球形细胞增多症可能性大	遗传性球形红细胞增多症
双眼缺血性综合征	眼缺血综合征
双下肢胫前动脉闭塞双下肢胫后动脉闭塞	胫前动脉闭塞##胫后动脉闭塞
双下肢动脉硬化伴斑块形成	肢体动脉硬化
皮肤黑色素沉着纳差	其他黑色素沉着过度##食欲不振
高LGE综合征	高IgE综合征
胃肠型感冒细菌性	胃肠型感冒##细菌感染
结肠癌术后，肝转移，肾上腺转移	结肠术后##癌##结肠恶性肿瘤##肝继发恶性肿瘤##转移性癌##肾上腺继发恶性肿瘤
胸主动脉夹层(DE BAKEYⅢ型)	主动脉夹层B型
肝恶性肿瘤射频消融治疗	肝恶性肿瘤##射频消融术后
肾功轻度异常浮肿	水肿##肾功能异常
1双侧侧脑室旁点状脱髓鞘改变	脱髓鞘性脑病
不全性粘连性肠梗组	不完全性肠梗阻##粘连性肠梗阻
左侧隐睾右侧腹股沟斜疝	单侧腹股沟斜疝
肺特指疾患洛菲氏不动杆菌	不动杆菌感染##肺的其他疾患
Poncet综合征不除外	结核性风湿病[篷塞病]
停经32周B超提示胎儿头围增大	孕32周
升结肠LST管状腺瘤	升结肠良性肿瘤##管状腺瘤
左尺桡骨远干骺端骺离骨折	桡骨远端骨骺分离##尺骨远端骨骺分离
慢性糜烂型胃炎	糜烂性胃炎
左肺下叶腺癌(TXNXM1)	左肺下叶恶性肿瘤##腺癌
电弧火焰烧伤双下肢	下肢烧伤##火焰烧伤##电流引起烧伤
糖尿病性周围神经病变可能	糖尿病性周围神经病
右肾小错构瘤	肾错构瘤
右上肺结节:肺癌	肺占位性病变##右肺上叶恶性肿瘤##癌
停经19周B超提示经后皮下无回声	妊娠状态
双下肢浮肿原因淋巴回流障碍	下肢水肿##淋巴回流障碍
躯体疾病伴发躯体化反应	躯体化障碍
腹膜后脂肪肉瘤术后三月，复发	腹膜后恶性肿瘤##脂肪肉瘤##恶性肿瘤复发##腹膜术后
假性甲状旁腺减退症	假性甲状旁腺功能减退
右尿路结石术后	泌尿系结石##尿道术后
回盲部低分化腺癌	腺癌##回盲部恶性肿瘤
胸闷待查冠心病心绞痛？高血压糖尿病	胸闷##冠状动脉粥样硬化性心脏病##心绞痛##高血压##糖尿病
外伤后右三叉神经1支损伤	三叉神经损伤
左侧腘窝皮下肿块	下肢肿物##皮肤肿物
左上肺碘125放射性粒子植入术	放射治疗
左下肢无力儿麻后遗症	肢体无力##脊髓灰质炎后遗症
喘大气待查：心肌损伤	喘息##心肌损害
宫颈低分化腺癌Ⅰb1期	子宫颈恶性肿瘤##腺癌
直肠腺癌 第一次化疗	直肠恶性肿瘤##化学治疗##腺癌
T型引流管置换胆囊	T型引流管置换
重度骨质疏松(绝经期)	重度骨质疏松##绝经期
垂体泌乳素腺瘤术后	垂体泌乳素瘤##垂体术后
B族链球菌感染(直肠)	链球菌感染##未特指的细菌性肠道感染
左侧胸前积液性质待查考虑恶性	恶性胸腔积液
喘息性支气管炎支气管肺发育不良？	气管支气管炎##先天性肺发育不全##先天性支气管发育不全
CGNFSGS高血压复诊	慢性肾小球肾炎##高血压##FSGS[局灶节段性肾小球硬化症]
左乳肿物:左乳癌	乳房肿物##乳腺恶性肿瘤##癌
化疗后白细胞下级	化疗药物反应##白细胞减少
脉络膜转移性肿瘤	脉络膜继发恶性肿瘤##转移性肿瘤
"非霍奇金淋巴瘤 放化疗,胃淋巴瘤,上呼吸道感染,既往乙肝感染,白细胞低下,疼痛,口腔炎"	非霍奇金淋巴瘤##恶性肿瘤放疗##化学治疗##胃淋巴瘤##上呼吸道感染##白细胞减少##疼痛##口炎
右第骨骨折并肺挫伤	肋骨骨折##肺挫伤
听神经鞘瘤	听神经瘤##听神经良性肿瘤
A7垂直阻生D2舌侧错位D3扭转	阻生牙##牙齿扭转##牙齿错位
神经瘫	瘫痪
非霍奇金间变大细胞淋巴瘤IV期B	非霍奇金淋巴瘤##间变性大细胞淋巴瘤
鼻部疤痕挛缩缺损	瘢痕挛缩##鼻部瘢痕
右下腹疼	下腹痛
右恶性肿瘤的对症治疗鳞癌	鳞状细胞癌
双侧腓胫动脉不全闭塞	胫动脉闭塞##腓动脉闭塞
右臀部不典型纤维组织瘤	臀部纤维瘤病
颈背部肿物	颈部肿物
左侧额颞顶混杂密度病变考虑慢性出血性病变	脑出血
双上肢瘢痕挛缩畸形	瘢痕挛缩##上肢瘢痕
双卵巢低中分化腺癌	卵巢恶性肿瘤##腺癌
下肢瘫痪	截瘫[双下肢瘫痪]
肝功能异常癌症放化疗	肝功能异常##化学治疗##恶性肿瘤放疗##癌症
结肠肝曲癌	结肠肝曲恶性肿瘤##癌
肝脏恶性肿瘤介入治疗	肝恶性肿瘤##恶性肿瘤介入治疗
急性发热性中性白细胞增多性皮肤病	急性发热性嗜中性皮病
停经31周B超提示胎儿卵圆孔增大	孕31周
复发性口疮性溃疡(待查)	复发性阿弗他溃疡
胃癌 疼痛 不能进食	胃恶性肿瘤##疼痛##进食障碍##癌
声带新生物	声带息肉
高血压Ⅰ期	高血压
直肠下段中分化腺癌放化疗	直肠恶性肿瘤##腺癌##恶性肿瘤放疗##化学治疗
"经典霍奇金淋巴瘤(IV期A,肺部广泛侵润)"	经典型霍奇金淋巴瘤##肺继发恶性肿瘤
体检先心（房间隔缺损）	房间隔缺损
右下肢纤维瘤	纤维瘤##下肢良性肿瘤
右腕掌割伤	腕部开放性损伤##手掌开放性损伤
胸腰椎退行性病变	腰椎退行性病变##胸椎退行性病变
"上呼吸道感染、发热、咳嗽咳痰,行动不便,纳差"	上呼吸道感染##发热##咳嗽##食欲不振
颈胸椎病损并截瘫	截瘫[双下肢瘫痪]
"支气管炎,盆腔炎\"	支气管炎##女性盆腔炎
前降支重度狭窄左旋支闭塞	冠状动脉狭窄##冠状动脉闭塞
MODS心脑凝血功能肝肾功能障碍	多脏器功能障碍综合征[MODS]
干燥综合征[舍格伦];胃炎;消化不良;系统性红斑狼疮;贫血;贫血;肾功能不全;骨关节病	干燥综合征[舍格伦]##胃炎##消化不良##系统性红斑狼疮##贫血##贫血##肾功能不全##骨关节病
慢性阻塞性肺气肿	慢性阻塞性肺疾病##肺气肿
右肺斑片影陈旧性病变可能性大	肺病##肺部阴影
被人用拳头及脚打伤全身多处	多处损伤
左肺部块状影及积液性质待查	肺部阴影
削水果时不慎被水果刀划伤右手指	"手指开放性损伤##接触刀、剑或匕首造成的损伤,在未特指场所"
右半结肠腺癌	结肠恶性肿瘤##腺癌
头面部瘀伤	面部损伤##头部损伤
十二指肠球部狭窄2次球囊扩张术	十二指肠狭窄
肾功能不全贫血	慢性肾衰竭(肾功能不全)合并贫血
1、(R93.203)肝占位性病变2、慢性乙型肝炎3、(K74.608)肝炎后肝硬化失代偿期	肝占位性病变##慢性乙型病毒性肝炎##肝炎肝硬化##O
胃窦管状腺癌根治术后(pT4N	胃术后##胃窦恶性肿瘤##管状腺癌
左下肢髂总静脉嵌压	髂总静脉压迫综合征[Cockett综合征]
取出右胫骨内固定装置	取出内固定装置
乙状结肠癌(PT3N2BM0 IIIC期)	乙状结肠恶性肿瘤##癌
肋骨转移癌	肋骨继发恶性肿瘤##转移性癌
宫内膜单纯性增生伴局部腺上皮非典型性	子宫内膜增生##宫颈上皮不典型增生
哮喘性支气管炎	支气管哮喘##支气管炎
胶质细胞瘤	"神经胶质瘤(除外鼻部神经胶质瘤,非肿瘤性)"
无精子症(睾丸活检术)	无精子症
马尾神经损害	马尾损伤
钙化上皮瘤？化脓性肉芽肿？	毛母质瘤##化脓性肉芽肿
其他为胎儿异常和损害给予的孕产妇医疗	为其他(可疑J胎儿异常和损害给予的孕产妇医疗
孕29+周腹痛：先兆流产？	孕29周##腹痛##先兆流产
左示指皮肤缺失伴小片甲床缺损	皮肤缺损
"非霍奇金淋巴瘤,口腔溃疡,化疗期间白细胞减少,失眠伴焦虑抑郁状态"	非霍奇金淋巴瘤##口腔黏膜溃疡##化学治疗##白细胞减少##失眠##焦虑状态##抑郁状态
尿面疹	尿布性皮炎
贫血伴血小板减少原因待查	贫血##血小板减少
1软骨恶性肿瘤23	未特指的四肢骨和关节软骨恶性肿瘤
糖尿病性周围神经病变脑神经脊神经均受累	糖尿病性周围神经病
腹痛-胃炎；腹腔感染	腹痛##胃炎##腹腔感染
残角子宫并腺肌症	子宫肌腺症##先天性残角子宫
心脏逆钟向转位T波改变	心电图异常
贫血原因待查 1.营养性贫血？ 2.骨髓增生异	贫血##营养性贫血##骨髓增生异常性贫血
右眉缺失上睑闭合不全	眼睑闭合不全[兔眼]
经量减少	月经稀少
"左肺不典型类癌,骨转移？"	左肺恶性肿瘤##骨继发恶性肿瘤##类癌瘤##转移性类癌
1全身肌张力增高待查	肌张力障碍
IgA肾病肝硬化相关可能	IgA肾病##肝硬化
前列腺特指疾病PSA增高原因待查	前列腺其他特指的疾患##PSA升高
1脑缺血脱髓鞘2心肌缺血	脱髓鞘性脑病##心肌供血不足
左侧第4前肋骨质破坏	骨质破坏
食道早期癌侵及粘膜肌层口侧局灶高级?	食管恶性肿瘤##癌
前额蜂蜇伤	蜂螫伤##头部损伤
结肠憩室穿孔	结肠憩室##结肠穿孔
左舟骨月骨无菌性坏死	月骨缺血性坏死##骨缺血性坏死
膝关节骨关节炎(左膝内翻畸形)	单侧膝关节骨性关节病##膝内翻
骨纤维性结构不良单骨性右侧腓骨	腓骨纤维结构不良
真菌团倾向曲霉菌	曲霉菌病
溃疡性中分化腺癌	腺癌
结肠溃疡型是分化腺癌	结肠恶性肿瘤##腺癌
结核性胸膜炎(右侧陈旧性)	陈旧性胸膜结核
右侧壁层胸膜见少量癌浸润结合免疫表	胸膜恶性肿瘤##癌
左拇指掌指关节半脱位虎口挛缩	掌指关节脱位##拇指关节脱位
额部外伤清创缝合术后	清创术后##头部开放性损伤
结肠癌术后 第二次化疗后	结肠恶性肿瘤##癌##恶性肿瘤术后化疗
糖尿病性末梢神经损坏脑供血障碍	脑血管供血不足##未特指的糖尿病伴有神经的并发症
颈腋下淋巴结大待查	颈淋巴结肿大##腋下淋巴结肿大
左颈部淋巴水囊肿	囊性淋巴管瘤##颈部肿物
子宫中分化子宫内膜样腺癌IIIA期术后一程化疗后	子宫恶性肿瘤##子宫内膜样腺癌##恶性肿瘤术后化疗
中枢性睡眠增多	嗜睡
胸腹腔镜食管癌切除术后3年	食管术后##食管恶性肿瘤##癌
交界逸搏心律	结性逸搏
左手拇指开放性脱位	拇指关节脱位##拇指开放性损伤
先天性房间膈缺损	房间隔缺损
右足扭伤	足部损伤
左面部腮裂瘘	鳃裂瘘
慢性心衰急性加重期心功能Ⅳ期	心功能IV级(NYHA分级)##慢性心力衰竭
肝肾功能不良	肝功能异常##肾功能异常
冠心病-不稳定心绞痛	冠状动脉粥样硬化性心脏病##不稳定性心绞痛
多发性骨髓瘤IgA型III期B组化疗后	多发性骨髓瘤
乳腺错构瘤	乳房错构瘤
左足拇趾趾间关节撕脱性骨折	拇趾骨折##足部关节骨折
鞍区占位病变垂体腺瘤	脑占位性病变##垂体腺瘤
双侧颈动脉粥样硬化伴斑块形成	颈动脉粥样硬化
宫颈鳞癌IIb期术后化疗后盆腔复发。	子宫颈恶性肿瘤##鳞状细胞癌##恶性肿瘤术后化疗##恶性肿瘤复发
泌乳综合征[福－奥二氏综合征]	停经泌乳综合征
胸水查见腺癌细胞	恶性胸腔积液##腺癌
鼻咽癌放脑病	鼻咽恶性肿瘤##放射性脑病
骨髓增殖性肿瘤（血小板增多症）	慢性骨髓增殖性肿瘤##血小板增多
胃窦病分化腺癌	胃窦恶性肿瘤##腺癌
右肾血管平滑肌脂肪瘤	肾错构瘤
海洛因药物瘾	海洛因药物瘾
短肠综合症肠切除后综全症	短肠综合征[肠切除后综合征]
乳腺腺泡扩张伴细胞化生	乳腺导管扩张症
淋巴细胞性白血病？？	淋巴细胞白血病
先天性鳃裂瘘管左先天性第一腮裂瘘管	鳃裂瘘
下咽癌化疗后	下咽恶性肿瘤##癌
右眼突眼原因待查右侧颈动脉海绵窦瘘待除外	眼球突出##海绵窦动静脉瘘
左膝关节创伤性OA伴强直	单侧膝关节骨性关节病##膝关节强硬
宫颈癌I期	子宫颈恶性肿瘤##癌
口腔颌面软组织外伤	口腔和咽喉部损伤
甲状腺双叶占位肥胖	肥胖##甲状腺占位
左小腿中下段左足跟后侧软组织缺损伴坏死	足坏死
癌细胞侵入胰腺组织并侵及十二指肠粘膜	癌##胰腺继发恶性肿瘤##十二指肠继发恶性肿瘤
右肘关节肱骨滑车撕脱性骨折	肱骨滑车骨折
卵巢低分化浆液性腺癌IIIc期	卵巢恶性肿瘤##浆液性腺癌
上唇基底细胞癌	唇恶性肿瘤##癌
双拇趾外翻右肘关节OA	肘骨关节病##足拇外翻
多囊肝合并感染可能性大	先天性多囊肝
希罗达手足综合症3级希罗达手足综合症3级	化疗药物反应
直肠绒毛状管状腺瘤伴低度上皮内瘤变	直肠良性肿瘤##管状绒毛状腺瘤
颜面出血点待查	出血斑点
左肾静脉压迫综合征	左肾静脉压迫综合征[胡桃夹现象]
颈椎病伴C3-7椎间盘突出	颈椎间盘突出
睾丸肿瘤化疗	睾丸恶性肿瘤##化学治疗
胸水查见异型细胞结合免疫表型疑为	胸腔积液
子宫内膜中高分化腺癌	子宫内膜恶性肿瘤##腺癌
急性胰腺炎性脊髓病可能性大	脊髓病##急性胰腺炎
慢性脱髓鞘性周围神经病	脱髓鞘病
关于肋缘外翻的观察甲状旁腺功能减低症	甲状旁腺功能减退
胆囊息肉(术后)	胆囊息肉##胆囊术后
胸水未见瘤细胞	胸腔积液
肾发育不良	肾发育不全
支气管哮喘并感染	支气管哮喘##感染
胆囊中低-分化腺癌	胆囊恶性肿瘤##腺癌
尿瘘术后	尿道瘘##尿道术后
宫颈鳞癌IIA2期化疗后	子宫颈恶性肿瘤##鳞状细胞癌##化学治疗
1荨麻疹，慢性2皮炎	慢性荨麻疹##皮炎
胃低分化腺癌根治术后ⅢB期 T4aN2M0	胃术后##胃恶性肿瘤##腺癌##淋巴结继发恶性肿瘤
骨髓细胞学示急性淋巴细胞白血病完全缓解	急性淋巴细胞白血病##急性淋巴细胞白血病
右眼原始玻璃体增生症	永存原始玻璃体增生症
慢性萎缩性胃大便干燥	慢性萎缩性胃炎##便秘
左腹股沟疝术后	单侧腹股沟疝##腹股沟术后
左大腿蜜蜂刺伤	蜂螫伤##大腿开放性损伤
双枕叶脑挫伤	多发性大脑挫裂伤
自身免疫性疾病多脏器受累	自身免疫病
左眼视网膜剥离术后	视网膜脱离##眼术后
4右大腿残端皮肤软组织缺血坏死	下肢皮肤坏死##下肢供血不足
鼻腔鳞癌T4aN1M0IVa期	鼻腔恶性肿瘤##鳞状细胞癌
小肠吸收不良综合征；	肠吸收不良
感觉性多神经病	其他特指的多神经病
停经345周MR提示胎儿后颅窝池增大	妊娠状态
双下肢大隐静脉曲张术后复发	大隐静脉曲张
双下肢软组织挫伤	"下肢未特指的损伤,水平未特指"
多脏器功能障碍神经系统循环系统凝血功能	多脏器功能障碍综合征[MODS]
冠心病心律失常型;水肿行动不便	冠心病心律失常型##水肿
晚孕胆瘀GDMA2	妊娠期肝内胆汁淤积症##妊娠期糖尿病
慢性胃十二指肠炎	胃十二指肠炎
腰5骶1间盘膨出骶管巨大囊肿	其他特指的椎间盘移位##椎管囊肿
右肝巨块型肝癌伴肝内转移，门静脉右支癌栓	肝恶性肿瘤##肝继发恶性肿瘤##门静脉瘤栓##癌##转移性癌
胃窦癌伴幽门梗阻	胃窦恶性肿瘤##幽门梗阻##癌
下颌骨成釉细胞瘤术后	成釉细胞瘤##下颌骨良性肿瘤
遗传性运动神经病	遗传性运动神经元病
腰椎压缩性骨折(骨水泥术后)	腰椎压缩性骨折##腰椎术后
颌面畸形	未特指的牙面畸形
上肢动脉阻塞	上肢动脉闭塞
T911椎体压缩性改变部分椎体退变	胸椎退行性病变##胸椎压缩性骨折
D1萌出乳牙未脱落	乳牙滞留
右肺上叶周围型腺癌	右肺上叶恶性肿瘤##腺癌
未分化多形性肉瘤	肉瘤
食管鳞癌维持性化学治疗	食管恶性肿瘤##鳞状细胞癌##恶性肿瘤维持性化学治疗
右髋臼及腰椎下段骨破坏	骨质破坏
胃壁间质瘤	胃肠道间质性瘤
"慢性气管炎,高血压,冠心病,重度骨关节病,失眠,行动不便,"	慢性气管炎##高血压##冠状动脉粥样硬化性心脏病##重度骨关节病##失眠
先天性三尖瓣发育不良	三尖瓣发育异常
胆道扩张症肝功能不良	胆管扩张##肝功能不全
RSA-2右单角子宫HT细胞免疫紊乱NK	单角子宫
"卵巢癌术后,盆腔复发?"	卵巢术后##卵巢恶性肿瘤##盆腔继发恶性肿瘤##癌##恶性肿瘤复发
钙沉着性角膜	角膜带状变性
肺磨玻璃样变待查	肺诊断性影像异常
肝M放化疗后	肝继发恶性肿瘤##恶性肿瘤放疗##化学治疗
胃体低分化腺癌伴印戒细胞癌IV期	胃体恶性肿瘤##腺癌##印戒细胞癌
上额窦炎	上颌窦炎
停经37周B超提示胎儿肠管扩张	孕37周
左颞叶肿物	脑占位性病变
胰腺副肿瘤神经系统综合征	神经系统副肿瘤综合征
双眼老年性黄斑变性	老年性黄斑变性
右下肺间质病变原因陈旧性病变	间质性肺病##肺病
热液烫伤后躯干双臀双下肢9%II°	下肢烫伤
色素性扁平苔藓灰皮病	扁平苔癣##灰色皮肤病
阴道恶性黑色素瘤	阴道恶性肿瘤##恶性黑色素瘤
慢性心功能衰竭心功能II级NYHA	心功能Ⅱ级(NYHA分级)##慢性心力衰竭
语言迟缓铁低锌低	言语障碍##锌缺乏##铁缺乏
腰椎神经根压迫症	椎间盘疾患引起的神经根和神经丛压迫(MS0-M51+)
泌尿系感染左肾肿大_多囊肾?	泌尿系感染##先天性多囊肾
生长评估阴囊阴茎融合维生素D不足铅暴露	维生素D缺乏##蹼状阴茎[阴茎阴囊融合]
多发转移癌	多部位继发恶性肿瘤##转移性癌
右肾错构瘤伴出血	肾错构瘤##肾出血
前列腺癌晚期	前列腺恶性肿瘤##癌
左膝关节滑膜皱襞嵌压	膝关节滑膜皱襞综合征
右乳腺癌新辅助化疗	乳腺恶性肿瘤##化学治疗##癌
短暂性缺血性脑血管疾病	脑血管供血不足
高位颈髓异常血管病变	血管性脊髓病
先天性胆管囊性扩张症IV型恶性变	先天性胆管扩张
双手抖动原因待查低血糖反应	不自主运动##未特指的低血糖
慢性炎症性脱髓鞘性多神经根神经病	脱髓鞘病
右肺小细胞癌维持性化学治疗	右肺恶性肿瘤##小细胞癌##恶性肿瘤维持性化学治疗
双侧胫前及右侧胫后动脉慢性闭塞型改变	胫后动脉闭塞##胫前动脉闭塞
第三颅神经麻痹	第三[动眼]神经麻痹
食管乳头状瘤术后	食管良性肿瘤##乳头状瘤
右输尿管上段结石并积水	输尿管结石##输尿管积水
右乳腺恶性肿瘤新辅助化疗后	乳腺恶性肿瘤##化学治疗
双侧颈动脉多发粥样硬斑形成	颈动脉粥样硬化
右腰背部囊肿	腰部囊肿##背部囊肿
原发性肝癌介入治疗后	肝恶性肿瘤##癌
左胫前皮肤伤口愈合不良	开放性损伤愈合不良
月经先后无定期病	月经紊乱
糖尿病并泌尿系感染	泌尿系感染##糖尿病
直肠肿物(癌?)	直肠恶性肿瘤##癌##直肠肿物
黄疸待查;肝损害	黄疸##肝功能异常
先天性二叶式主动脉瓣	主动脉瓣二瓣化畸形
结肠中分化腺癌根治术后PT4N1M0 盆腔转移	结肠术后##结肠恶性肿瘤##腺癌##盆腔继发恶性肿瘤##转移性粘液腺癌##淋巴结继发恶性肿瘤
胃食管交界区低分化腺癌IV期	食管胃连接部恶性肿瘤##腺癌
双卵巢中分化浆液性乳头状囊腺癌	卵巢交界性肿瘤##乳头状浆液性囊腺瘤
双眼屈光不正（屈光人工晶体术后）	屈光不正##人工晶体植入状态
腰骶部臀部外伤	下背损伤##臀部软组织损伤
头部跌伤后	头部损伤##摔伤
皮肤瘙痒症，甲减，类风湿性关节炎	瘙痒(症)##甲状腺功能减退##类风湿性关节炎
双肺广泛斑片影伴间质改变	肺部阴影
贲门癌放化疗后	贲门恶性肿瘤##化学治疗##恶性肿瘤放疗##癌
子宫恶性潜能未定肌瘤	子宫平滑肌瘤##潜在恶性未肯定的平滑肌瘤
左足跟玻璃割伤	足部开放性损伤##玻璃割伤
子宫内膜低分化子宫内膜样腺癌	子宫内膜恶性肿瘤##子宫内膜样腺癌
压疮14胆囊沉积物	压疮
左侧面部右侧颈部多发割伤	面部开放性损伤##颈部开放性损伤
右侧睾丸胚胎癌	睾丸恶性肿瘤##胚胎性癌
宫颈病CIN2－3级宫宫颈环切术	子宫颈上皮内瘤变III级[CINIII级]##宫颈上皮瘤样病变[CIN]II级##宫颈术后
胃肠道紊乱	胃肠功能紊乱
开水烫伤全身多处	沸水烫伤##多发烫伤
脊柱隐裂	先天性隐性脊柱裂
"贲门肿瘤,恶性(术后)"	贲门恶性肿瘤
不典型癣	未特指的皮肤癣菌病
突发性耳聋特发性聋	突发性聋##特发性突聋
电击伤双下肢	"下肢未特指的损伤,水平未特指##电击伤"
横结肠1管状腺瘤横结肠2管状腺瘤	管状腺瘤##横结肠良性肿瘤
1.新生儿溶血病（ABO）	新生儿ABO血型不合溶血病
左冈上肌止点撕脱性骨折	肱骨骨折
儿保小头围精神运动发育落后	发育迟滞
HTN/蛋白尿/血肌酐升高	高血压##蛋白尿##O
左侧颈动脉海绵窦瘘术后	海绵窦动静脉瘘
尿路造口术后	泌尿道的其他人工造口状态
右耳廓挫裂伤	耳廓挫伤
四肢躯干无力原因待查格林巴利综合症不除外	肢体无力##吉兰-巴雷综合征
双侧乳腺增生伴双乳囊肿	乳腺增生##乳腺囊肿
左眼人工晶体植入状态右眼黄斑陈旧性病变	人工晶体植入状态##视网膜病
腹部膨隆原因待查Cushing综合征	皮质醇增多症[库欣综合征]
甲旁腺功能低下	甲状腺功能减退
宫颈低度病变CINI	子宫颈上皮瘤样病变[CIN]I级
黄斑变性注药术后	黄斑变性##眼术后
冠心病-心功能Ⅰ级	冠状动脉粥样硬化性心脏病##心功能I级(NYHA分级)
胎儿宫内死亡	胎死宫内
宫颈炎性疾病，子宫肌瘤术后	宫颈炎性疾病##子宫平滑肌瘤##子宫平滑肌瘤##子宫术后
骨盆多发性骨质破坏待查甲旁亢骨病	骨质破坏##甲状旁腺功能亢进
左中指末节指骨部分缺损皮肤及软组织缺损	皮肤缺损
眼底黄斑病变视瞻昏渺	视神经盘的其他疾患
有重度合并症血糖持续不稳定的糖尿病患者	糖尿病
右胫腓骨双骨折	腓骨骨折##胫骨骨折
1.左内外踝骨折	内踝骨折##外踝骨折
"左肺上叶占位,胸部CT穿刺 出血倾向 局麻"	肺占位性病变##出血倾向
右侧股骨头骨折并髋臼粉碎性骨折	股骨头骨折##髋臼骨折
高尿酸植物神经紊乱	植物神经功能紊乱##高尿酸血症
左股骨干骨折术后内固定物取出术后	股骨干骨折##骨折术后##取出内固定装置
右中肺鳞癌	右肺中叶恶性肿瘤##鳞状细胞癌
喉咽癌	喉咽恶性肿瘤##癌
C6-7脊髓内脱髓鞘改变	脱髓鞘性脊髓病
颈椎病;颈椎小关节紊乱;眩晕	颈椎病##颈椎小关节紊乱
痤疮瘢痕	痤疮##瘢痕
右肺钙化结节	肺钙化##肺占位性病变
双神经性聋左耳混合聋	双侧感音神经性聋##单侧混合性聋
右侧肾上腺醛固酮瘤	康恩综合征[Conn综合征]
脊柱OA伴狭窄	脊柱骨关节病
中度周围神经病变以轴索改变为主	轴索性周围神经病
右输尿管结石并肾积水	肾积水伴输尿管结石
宫腔赘生物宫颈管赘生物	子宫息肉##子宫颈息肉
糖尿病右下肢坏疽	糖尿病性坏疽
尿道阴道部新生物	尿道息肉##阴道息肉
右肺下叶癌伴双肺多发转移右肺下叶癌伴双肺多发转移	右肺下叶恶性肿瘤##肺继发恶性肿瘤##肺下叶恶性肿瘤##肺继发恶性肿瘤##癌##转移性癌
腹膜后多形性恶性纤维组织细胞瘤	腹膜后恶性肿瘤##恶性纤维组织细胞瘤
脾静脉内瘤栓	脾静脉栓塞##肿瘤栓子
右额叶胶质母细胞瘤	额叶恶性肿瘤##胶质母细胞瘤
滋养层肿瘤	滋养细胞病
早孕高龄初产先兆流产	妊娠状态##高龄初孕妇的妊娠监督##先兆流产
冠状动脉前降支中段心肌桥形成	冠状动脉肌桥
左髋痛胸腰畸形;骨质疏松	下肢疼痛##骨质疏松##脊柱畸形
多发性骨髓瘤 (IGG K轻链型 DS分期IIA期 ISS分期II期 NCR)	多发性骨髓瘤(IgGк型)##多发性骨髓瘤(轻链к型)##多发性骨髓瘤(DS分期II期)##多发性骨髓瘤(ISS分期II期)
肾继发性病综合征	肾病综合征
肺癌，镜下血尿	肺恶性肿瘤##血尿##癌
腰椎骨折术后	腰椎骨折##骨折术后
"高血压病,高血压病，抑郁症"	高血压##高血压##抑郁症
右肺下叶GGO	肺部阴影
高血压;慢性肾功能不全;肾性骨病;下肢静脉回流障碍;肾性贫血	高血压##慢性肾功能不全##肾性骨病##O##肾性贫血
食欲欠佳	食欲不振
"右乳癌IV期术后,肝转移,骨转移,赫赛汀耐药"	乳腺术后##乳腺恶性肿瘤##癌##肝继发恶性肿瘤##骨继发恶性肿瘤##转移性癌
"乳腺癌术后,放射治疗 腰部疼痛,慢性支气管炎，行动不便"	恶性肿瘤术后放疗##乳腺恶性肿瘤##癌##腰痛##慢性支气管炎
肝内胆管囊样扩张症Caroli病	先天性肝内胆管囊状扩张症[Caroli病]
颞叶内侧脑组织局部胶质细胞轻度增生	脑胶质细胞增生
眶下软组织外伤	眼和眶未特指的损伤
肝脾挫伤	肝挫伤##脾损伤
左侧鼻前庭新生物	鼻息肉
乳腺纤维囊性乳腺病	乳腺囊性增生病
盆腔放疗后	放射治疗
点状角膜炎	浅层点状角膜炎
肝弥漫性病变原因待查免疫性肝病可能性大	未特指的肝病
双输尿管积水	输尿管积水
病毒性肝炎慢性乙型病毒性肝炎慢性乙型	慢性乙型病毒性肝炎
消化道癌	消化道恶性肿瘤##癌
左下肢左髋骶尾部压迫性溃疡	压疮
双膝髌骨局灶性骨梗死骨代谢异常	骨坏死
"行动不便,慢性失眠,消化不良,呕吐,胃溃疡、反酸咽喉肿痛,感冒咽炎咳嗽咳痰,便秘,重度骨关节炎"	失眠##消化不良##呕吐##胃溃疡##反酸##感冒##咽炎##咳嗽##便秘##重度骨关节病
多脏器功能不全心肝凝血	多脏器功能障碍综合征[MODS]
静脉曲张下肢水肿	下肢静脉曲张##下肢水肿
左外耳道闭锁左耳腮裂瘘管	鳃裂瘘##先天性外耳道闭锁
右侧腹壁软组织伤	腹部损伤
外周动脉硬化并狭窄	动脉硬化##动脉狭窄
宫颈癌IIB期术后：阴道顶端肉芽增生伴出血	宫颈术后##子宫颈恶性肿瘤##癌##阴道出血
牙周感染	牙周炎
右乳腺增生伴钙化	乳腺增生##乳腺钙化
"食管癌抗过敏,胃镜检查预防出血,抗过敏化疗肝损伤,化疗预处理,水肿利尿,化疗呕吐,反流性食道炎伴溃疡"	食管恶性肿瘤##化疗药物反应##肝损伤##水肿##化疗药物反应##呕吐##反流性食管炎##食管溃疡##癌
霉菌性足分支菌病	真菌性足菌肿
意识障碍待查肠管积气原因待查	肠胀气##意识障碍
火焰烧伤面部	火焰烧伤##面部烧伤
阴道前壁膨出Ⅲ子宫颈脱出Ⅲ	子宫脱垂Ⅲ度##阴道前壁脱垂
白细胞血小板继发性减少症	继发性血小板减少##白细胞减少
梅尼埃氏病	梅尼埃病
陈旧性虹膜炎	虹膜炎
纤维脂肪组织灶性坏死伴大量死骨形成	骨坏死
右前颅底曲菌病	曲霉菌病
喉部恶性芽肿	坏疽性肉芽肿
手湿疹；白斑？	"湿疹##白斑病,不可归类在他处者"
软组织肉瘤肠系膜脂肪肉瘤	脂肪肉瘤##软组织肉瘤##肠系膜恶性肿瘤
右手腕部皮肤软组织撕脱并部分缺损	上肢撕脱伤##上肢皮肤缺损
"前列腺癌,双腹股沟淋巴结转移"	前列腺恶性肿瘤##癌##腹股沟淋巴结继发恶性肿瘤##转移性癌
"肾病,慢性胃窦炎"	肾病
慢性静脉功能不全	静脉功能不全(慢性)(周围性)
右侧输卵管伞端闭锁并积血	输卵管血肿##输卵管闭锁
右侧颞顶外伤性颅骨缺损右侧动眼神经瘫	动眼神经麻痹##后天性颅骨缺损
双侧胸腔积血	血胸
T12-L1压缩性骨折	胸椎压缩性骨折##腰椎压缩性骨折
"高血压病,糖尿病,冠心病，皮炎,心律失常,泌尿道感染"	高血压##糖尿病##冠状动脉粥样硬化性心脏病##皮炎##心律失常##泌尿系感染
头颈部刀砍伤	头部开放性损伤##颈部开放性损伤##刀砍伤加害
急性髓系白血病M6	急性红白血病(M6型)
纵膈血肿积气	纵隔气肿##纵隔血肿
隐睾新生儿双侧	先天性双侧隐睾
双膝外侧盘状半月板轻度OA骨代谢异常	先天性盘状半月板##膝骨关节病
阴道口色素沉着	色素沉着未特指的疾患
脐窦	脐窦
右小腿截肢小腿残端破损	截肢
慢性支气管炎急性加重	慢性支气管炎急性发作
睑肌痉挛	睑痉挛
脊柱病除外后颅窝病变	脊椎病
入院心电图：窦性心律，非特异性T波异常	非特异性ST-T改变
突发性耳聋(特发性聋)	突发性聋
乙状结肠粘液腺癌伴梗阻、肝转移 pT4N0M1 IVa期	乙状结肠恶性肿瘤##粘液腺癌##结肠梗阻##肝继发恶性肿瘤##转移性粘液腺癌
肺浸润性腺癌	肺继发恶性肿瘤##腺癌
右腓总神经鞘瘤	下肢周围神经和自主神经良性肿瘤##神经鞘瘤
升结肠高分化腺癌	升结肠恶性肿瘤##腺癌
非霍奇金淋巴瘤 滤泡性	未特指的滤泡性非霍奇金淋巴瘤
肾盂动态未定肿瘤	肾盂动态未定或动态未知的肿瘤
外耳道炎，急性	急性外耳道炎
西医1神经症2脑多发腔隙灶	神经症性障碍##腔隙性脑梗死##多发性脑梗死
"右肺腺癌 IIIB期,白细胞减少,放射性食管炎,骨转移,肺部感染,维生素缺乏,化疗前预处理"	右肺恶性肿瘤##腺癌##白细胞减少##放射性食管炎##骨继发恶性肿瘤##肺部感染##维生素缺乏
右踝肿块	下肢肿物
慢性肾衰竭CKD	慢性肾衰竭
坏死组织及大量真菌菌丝和孢子	真菌感染
乳腺非典型增生	乳腺增生
右眼裂小待查	睑裂狭小
脑梗死;高脂血症;痛风;周围神经病;睡眠障碍;焦虑障碍;急性前列腺炎	脑梗死##高脂血症##痛风##多发性神经病[多发性神经炎/周围神经炎]##睡眠障碍##焦虑障碍##急性前列腺炎
C7龋齿A8牙本质过敏	龋病##牙本质过敏症
双肺间质性改变不除外间质纤维化请结合病史	肺间质纤维化##间质性肺病
母体胎膜早破新生儿	胎儿和新生儿受胎膜早破的影响
右侧乳房溢血	乳头溢液
左面部皮肤恶性黑素瘤	面部其他和未特指部位的恶性黑色素瘤
远端脾肾分流术后，门静脉高压症	门脉高压
1左肱骨头坏死伴缺损2左肩关节继发性	肱骨头缺血性坏死
妊娠39+6周，孕5产1，单活胎，LOA，剖宫产	无指征剖宫产的单胎分娩
肝功能失代偿期腹水形成	肝硬化失代偿期##腹水
颅内真菌感染	颅内感染##真菌感染
头晕.下肢浮肿[脾肾不足.血脉瘀滞]	头晕##下肢水肿
肠粘膜松弛内套叠	肠套叠
糖尿病周围病变	糖尿病
HUNT综合症左化脓性软骨膜炎	拉姆齐-亨特综合征[Ramsy-Hunt综合征]
右眉弓玻璃划伤	玻璃割伤##前额开放性损伤
直肠癌放化疗 后	直肠恶性肿瘤##癌##恶性肿瘤放疗##化学治疗
异位甲状旁腺	甲状旁腺异位
回肠美克尔憩室炎	麦克尔憩室##小肠憩室炎
H59802青睫综合征	青光眼睫状体炎危象[青光眼睫状体炎综合征]
全身多处皮肤擦挫伤（污染严重）	多处损伤
盆腔无性细胞瘤	无性细胞瘤##盆腔恶性肿瘤
肱骨恶性肿瘤(骨肉瘤)	肱骨恶性肿瘤##骨肉瘤
骶尾部脂肪瘤型脊髓栓系	多发性脂肪瘤##骨盆良性肿瘤
颅脑缺损伴脑室扩大	脑室扩张##颅脑开放性损伤
外伤性瞳孔强直左	艾迪氏综合征[Adie瞳孔]
脑梗死多发颅内血管狭窄	脑梗死
马德隆畸形	马德隆畸形
前臂纤维瘤	前臂纤维瘤病
冠心病不稳定性心绞痛陈旧心梗	冠状动脉粥样硬化性心脏病##不稳定性心绞痛##陈旧性心肌梗死
眼视神经瘤	神经瘤##视神经良性肿瘤
右前臂刀刺伤	前臂开放性损伤##刀刺伤
右胫腓神经脱髓鞘改变	脱髓鞘病
糖尿病性神经病变足病	糖尿病足
胃窦隆起糜烂	糜烂性胃炎
双侧急性硬膜下血肿	硬膜下血肿
退变性椎间盘病DDD	椎间盘变性
左踝关节前方滑膜撞击征左足副舟骨	踝关节撞击综合征##先天性足副舟骨
心房纤维性颤动已转为窦性	心房颤动[心房纤颤]
宫颈腺体囊性增生伴局部腺体低级别异型增生	子宫内膜囊性增生
"深静脉血栓形成,肺腺+130:400癌IV期,肝功能损伤,化疗呕吐,白细胞减少 中性粒细胞减少"	静脉血栓形成##肺恶性肿瘤##腺癌##肝功能异常##化疗药物反应##呕吐##白细胞减少##中性粒细胞减少症
尿布疹5卵圆孔未闭	卵圆孔未闭##尿布性皮炎
胃低分化腺癌	胃恶性肿瘤##腺癌
LN复查手裂口化脓	狼疮性肾炎##手部开放性损伤
"尿毒症;高血压;冠心病心律失常型;高脂血症;糖尿病;肾性贫血;静脉血栓形成,透析中低血压"	尿毒症##高血压##冠心病心律失常型##高脂血症##糖尿病##肾性贫血##静脉血栓形成##肾脏透析状态##低血压
Alzheimer病混合型	阿尔茨海默病(混合型)
右小腿及足背皮肤缺损并坏死	下肢皮肤坏死##下肢皮肤缺损##足坏死##皮肤缺损
新生儿狼疮	新生儿狼疮综合征
左侧距骨及跟骨撕脱性骨折	距骨骨折##跟骨骨折
直肠息肉-管状腺瘤伴低级别上皮内瘤变	直肠良性肿瘤##直肠息肉##管状腺瘤
左侧股骨头以及髋臼囊性变	股骨骨囊肿##髋关节囊肿
前降支浅肌桥	冠状动脉肌桥
皮肤感染性肉芽肿	皮肤感染##肉芽肿
宫内环下移2绝经	避孕环移位##绝经期
腸炎，上呼吸道感染，胃溃	肠炎##上呼吸道感染##胃溃疡
宫颈高级别上皮内病变CINIII级	子宫颈上皮内瘤变III级[CINIII级]
急性移植物抗宿主反应病I级皮肤	急性移植物抗宿主病
左眼神经损伤	身体未特指部位的神经损伤
子宫内膜中分化子宫内膜样腺癌	子宫内膜样腺癌##子宫内膜恶性肿瘤
胸椎骨质破坏并不全瘫	不完全性瘫痪##骨质破坏
喉咽癌 T4N2M0 IV期	喉咽恶性肿瘤##癌##淋巴结继发恶性肿瘤
左卵巢子宫内膜样癌化疗后	子宫内膜样癌##卵巢恶性肿瘤##化学治疗
食管下段鳞癌	食管下三分之一的恶性肿瘤##鳞状细胞癌
上肢动颈脉内瘘闭塞	人工动静脉瘘闭塞
言语不清待查脑血管疾病其他	脑血管病##意识障碍
局灶-继发全身发作枕叶发作	枕叶性癫痫##癫痫部分性发作##癫痫大发作[全身强直-阵挛性发作]
早孕高PRL血症	妊娠状态##高泌乳素血症
腹痛; 肠癌术后	腹痛##胃肠道恶性肿瘤##癌
双侧肾癌	肾恶性肿瘤##癌
左膝股骨近端骨梗死髌股关节软骨退变	单侧膝关节骨性关节病##骨坏死
右颈肿痛	颈痛##颈部肿胀
排尿混浊?左阴囊疼痛	疼痛
贲门腺癌	贲门恶性肿瘤##腺癌
痹证寒湿痹阻证西医诊断1腰椎间盘膨出症	腰椎间盘移位
多浆膜积液待查	多发性浆膜腔积液
"右肺鳞癌IV期，肝癌,失眠"	右肺恶性肿瘤##鳞状细胞癌##肝恶性肿瘤##失眠
右下肺肿块:肺癌	右肺下叶恶性肿瘤##癌##肺肿物
左手第一掌指关节面碎裂并缺损	手部关节骨折
颈部前胸部猫抓伤	"被其他哺乳动物咬伤或抓伤,在未特指场所##颈部开放性损伤##胸部开放性损伤"
食道癌放疗	食管恶性肿瘤##癌##恶性肿瘤放疗
高血压，脑梗塞缺血，	高血压##脑梗死##脑血管供血不足
右足踇趾崁甲	足趾损伤##嵌甲
右示指皮肤缺失皮肤软组织缺失	皮肤缺损
口底表皮肥厚口底皮瓣肥厚	其他表皮肥厚
右肺空洞性质待查	肺病
牙龈挫伤	牙及相关组织损伤
右示指末节缺损毁损伤	手指损伤
乳腺肿瘤(化疗后)	乳腺恶性肿瘤##化学治疗
右输尿管结石并右肾积液	肾积水伴输尿管结石
1右股骨髂骨骨质破坏2肠蛔虫	骨质破坏##肠蛔虫病
双胎13死胎725复白带	双胎妊娠##胎死宫内
四肢骨痛	骨痛
宫外孕破裂休克	异位妊娠后子宫破裂##休克
腰1椎体爆裂骨折	腰椎骨折L1
头外伤后神经反应软组织挫伤感染水肿疼痛	头部损伤##感染##头痛##水肿
右侧陈旧性腔隙性脑梗死	腔隙性脑梗死
先天性发育不良	先天性发育异常
双髋关节退行性改变	双侧髋关节骨性关节病
溶血性尿毒综合症不除外	溶血-尿毒综合征
"左面颈部及牙龈肿物，CA?,疼痛"	面部肿物##颈部肿物##癌##疼痛##O
游离体骨和软骨结构	关节游离体
颈45不稳伴退变	颈椎不稳定##颈椎退行性病变
右眼视网膜裂孔伴局限性脱离	视网膜裂孔##视网膜脱离
多发性周围神经运动支感觉支脱髓鞘异常	脱髓鞘病##多发性神经病[多发性神经炎/周围神经炎]
2型糖尿病可能性大糖尿病酮症酸中毒	2型糖尿病##2型糖尿病性酮症酸中毒
先天性浮棘骶椎管囊肿	椎管囊肿
双眼屈光不正(近视)	近视##屈光不正
右胫动脉重度狭窄近闭塞	胫动脉狭窄##胫动脉闭塞
颈6-7髓内病变伴脊髓空洞	脊髓空洞症##脊髓病
肋骨瘤可能	肋骨良性肿瘤##骨瘤
二尖瓣瓣环发育差	二尖瓣发育不良
卵巢良性畸胎瘤	卵巢良性肿瘤##良性畸胎瘤
阑尾炎术后腹胀	阑尾炎##阑尾术后##腹胀
颅内多发腔隙性梗塞	腔隙性脑梗死##多发性脑梗死
背部色素斑	色素斑
双侧基底节区小腔隙灶脑白质脱髓鞘改变	脱髓鞘性白质脑病##腔隙性脑梗死
肋骨胸椎骨质破坏待查	骨质破坏
右肺中叶NSCLC	非小细胞癌##右肺中叶恶性肿瘤
evens综合症	自身免疫性溶血性贫血
冠心病心房纤颤高血压头痛	冠状动脉粥样硬化性心脏病##心房颤动[心房纤颤]##高血压##头痛
绝经期女性严重骨质疏松伴骨痛	绝经后骨质疏松##骨痛
右肺中叶支气管外压性狭窄	支气管狭窄
左侧颈内动脉窦部动脉夹层伴眼段闭塞	颈内动脉夹层##颈内动脉闭塞
颈椎硬膜外血肿伴不全瘫	不完全性瘫痪##硬膜外血肿
腹膜后及腹腔内多发稍大淋巴结	腹腔淋巴结肿大##腹膜后淋巴结肿大
月经不调早孕	月经紊乱##妊娠状态
十二指肠球部病变伴穿孔	十二指肠穿孔##胃和十二指肠未特指的疾病
右上颌窦为大量胶原变性组织伴钙盐沉积	钙质沉着症
左桡骨下端骨不连	桡骨骨折不连接
右颈部瘘管符合腮裂瘘	鳃裂瘘
右乳外上象限纤维腺瘤	乳腺良性肿瘤##纤维腺瘤
骨髓MM化疗后部分缓解骨髓象浆细胞7	多发性骨髓瘤##化学治疗
骨盆尤文氏肉瘤	尤因肉瘤##骨盆部肿瘤
右肺腺癌伽玛刀治疗后化疗后	右肺恶性肿瘤##腺癌##化学治疗##恶性肿瘤放疗
脑脊液异常所见表皮葡萄球菌	葡萄球菌感染
右枕叶血管畸形	头部血管畸形
周身游走性疼痛	疼痛
人偏肺病毒阳性	病毒感染
右腘窝疤痕挛缩	瘢痕挛缩##下肢瘢痕
肋间软组织劳损	躯干未特指关节和韧带脱位、扭伤和劳损
1新生儿胎粪综合征	新生儿胎粪吸入综合征
胃疼病全麻胃肠镜检查丙泊酚不耐受	胃痛
胃窦癌伴肝转移术后	胃窦恶性肿瘤##癌##肝继发恶性肿瘤##转移性癌
低分化腺鳞癌	鳞状细胞癌
慢性主观性头昏脑白质缺血	脑血管供血不足##头晕
孕1产0孕38+1周待产胎膜早破	孕38周##胎膜早破
胆管错构瘤可能	胆管错构瘤
颜面肿	面部肿胀
上腹痛待查；消化道出血;	上腹痛
右手中指伸肌腱止点撕脱性骨折	指骨骨折
停经296周B超提示胎儿双侧肾盂轻度分离	妊娠状态
非霍杰金淋巴瘤弥漫大B细胞型	弥漫大B细胞淋巴瘤
妊娠合并乙肝病毒携带	乙型病毒性肝炎病原携带者##妊娠状态
右面部Mikulicz病	米库利奇病
直肠中-高分化腺癌	直肠恶性肿瘤##腺癌
大疱性表皮松解坏死型药物疹	莱尔综合征[lyell综合征]
右乳浸润性导管瘤	乳腺恶性肿瘤##浸润性导管癌
肝胃不和血脂高	高脂血症
12牙根发育不全	牙根发育不良
宫颈非角化型鳞状细胞癌	子宫颈恶性肿瘤##鳞状细胞癌
右侧鼻翼皮肤肿物	鼻部肿物##皮肤肿物
病态窦房结综合症专科检查	病态窦房结综合征
上睑粘液癌()	眼睑恶性肿瘤##粘液癌
膈肌痉挛？胃炎？反流性食管炎？	痉挛##胃炎##反流性食管炎
横结肠管状腺瘤伴低级别上皮内瘤变	横结肠良性肿瘤##管状腺瘤
左眼虹膜周边切除术房角分离术	眼术后
肾错构瘤左侧	肾错构瘤
急性化脓性阑尾炎、（肠）麦克儿憩室	急性化脓性阑尾炎##麦克尔憩室
踝关节前踝骨裂	踝关节骨折
"贫血,妊娠"	贫血##妊娠状态
颈部软组织感染合并淋巴结炎	颈部软组织感染##颈淋巴结炎
节育器宫颈异位嵌顿	避孕环嵌顿
双肋缘明显外翻原因待查胃口差抵抗差	食欲不振##肋骨畸形
"肝占位,肝癌"	肝恶性肿瘤##癌##肝占位性病变
心功能II级(KILLIP分级)	KillipII级
L5椎体结核	腰椎结核
左侧肢体无力待查颈腰椎病	偏侧肢体无力##颈椎病##腰椎病
胆结石高血压病胃脘痛咽痛结膜炎	胆石症##高血压##胃痛##咽痛##结膜炎
胸45椎体破坏伴截瘫	截瘫[双下肢瘫痪]
左肺高代谢病灶查因	肺诊断性影像异常
"全子宫切除术后,盆腔囊肿,包裹性积液,直肠类癌术后,肠镜检查,出血倾向,肠道准备"	O##盆腔囊肿##盆腔包裹性积液##直肠术后##直肠恶性肿瘤##类癌瘤##出血倾向
股骨头坏死右	股骨头缺血性坏死
右侧室管膜下囊肿	室管膜囊肿
重度颅脑外伤性	头部损伤
"升结肠ca术后复查,肠镜检查 肠道准备"	升结肠恶性肿瘤##结肠术后##癌
多脏器功能不全心脏肾脏消化道凝血代谢	多脏器功能障碍综合征[MODS]
左耳面神经瘤	神经瘤##面神经良性肿瘤
高血压特病	高血压
双髋退变	双侧髋关节骨性关节病
乙状结肠管状腺癌	乙状结肠恶性肿瘤##管状腺癌
胃间质瘤朮后	胃肠道间质性瘤##胃术后
(FLJC)甲状腺ca术后	甲状腺恶性肿瘤##甲状腺术后##癌
左眼小柳－原田氏病	Vogt-小柳原田综合征
直肠低中分化管状腺癌	直肠恶性肿瘤##管状腺癌
上呼吸道感染，咽喉肿痛；足膝红肿；	上呼吸道感染
肺上叶支气管恶性肿瘤	支气管恶性肿瘤##肺上叶恶性肿瘤
骨盆转移癌	盆骨继发恶性肿瘤##转移性癌
白血病诱导缓解治疗	白血病
直肠绒毛管状腺瘤不除外有更严重病变可能	直肠良性肿瘤##管状绒毛状腺瘤
关节退行性改变	骨关节病
呼吸道感染胸闷;佝偻病	呼吸道感染##胸闷##O
女性盆腔囊肿	盆腔囊肿
咽鼓管开放症左咽鼓管功能不良	咽鼓管未特指的疾患
右胸腰部软组织裂口	胸部开放性损伤##下背开放性损伤
胎盘局部见钙盐沉积和灶性中性白细胞浸润	钙质沉着症
左上颌根尖炎性病变	根尖周炎
慢性结肠炎伴肠功能紊乱	慢性结肠炎##肠功能紊乱
高血压冠心病阴道炎	高血压##冠状动脉粥样硬化性心脏病##阴道炎
右乳浸润导管癌保乳术后	乳腺恶性肿瘤##浸润性导管癌##乳腺术后
晚孕(上感)	妊娠状态##上呼吸道感染
右侧腹股沟疖肿	腹股沟脓肿##皮肤疖肿
取除子宫内节育器	取出子宫内避孕装置
脂肪性肝病	脂肪肝
近肝曲横结肠绒毛管状腺瘤伴中度异型增生	横结肠良性肿瘤##管状绒毛状腺瘤
左侧颈动脉海绵窦瘘	海绵窦动静脉瘘
腰椎压缩性骨折术后	腰椎压缩性骨折##骨折术后
腰椎oa心脏病	未特指的心脏病##脊椎退行性病变
静脉特指疾患左上臂头静脉破裂	静脉其他特指的疾患
1021咽拭子病毒筛查示EV71病毒阳性	手足口病
左乳腺癌肺骨转移放化疗	乳腺恶性肿瘤##癌##肺继发恶性肿瘤##骨继发恶性肿瘤##化学治疗##放射治疗##转移性癌
停经293周MR提示胎儿左肾稍大肾盏扩张	妊娠状态
腮弓综合症附耳双	先天性副耳##第一、二鳃弓综合征[Goldenhar综合征]
梗阻性膀胱	膀胱颈梗阻
眼部蜂窝织炎	蜂窝织炎
右膝关节骨关节炎	单侧膝关节骨性关节病
主动脉栓塞和血栓形成	主动脉其他和未特指部位的栓塞和血栓形成
妄想	妄想状态
甲状腺易位	甲状腺异位
回肠双腔造瘘术后	回肠造口状态
双侧支气管扩张	支气管扩张症
肝癌冷冻术后/乙肝肝硬化	肝术后##肝恶性肿瘤##乙型肝炎肝硬化##癌
胸腔积血	血胸
左侧颈部淋巴组织增生性病	淋巴组织增生病
右侧髂血管旁淋巴结肿大	淋巴结肿大
"多发性骨髓瘤 (IGD LAMBDA型)D-S分期ⅢB期,ISS分期I期"	多发性骨髓瘤(IgDλ型)##多发性骨髓瘤(DS分期III期B组)##多发性骨髓瘤(ISS分期I期)
缺钙，背部疼痛	背痛
右侧坐骨囊肿	骨盆部囊肿
胸腰椎多发压缩性骨折	胸椎压缩性骨折##腰椎压缩性骨折
四肢抖动待查低钙脑损伤新生儿良性惊	不自主运动##低钙血症##良性新生儿惊厥##新生儿脑损伤
宫颈腺癌，低分化	子宫颈恶性肿瘤##腺癌
子宫内膜低分化浆液性腺癌	子宫内膜恶性肿瘤##浆液性腺癌
COPD稳定期	慢性阻塞性肺疾病
甲状腺癌术后 左侧颈部淋巴结肿大	甲状腺术后##甲状腺恶性肿瘤##颈淋巴结肿大##癌
阑尾黏液腺癌	阑尾恶性肿瘤##粘液腺癌
主动脉弓缩窄CHF	主动脉弓狭窄##充血性心力衰竭
上肢恶性黑色素瘤	上肢恶性黑色素瘤##恶性黑色素瘤
双手肌萎缩	肌肉萎缩
完全流产	"流产,完全性或未特指,无并发症"
先天性心脏病术后（室间隔缺损）	先天性心脏病术后##室间隔缺损
重型闭合性颅脑损伤	闭合性颅脑损伤重型
食管胸中段癌	食管胸中段恶性肿瘤##癌
心功能KILLIPI级	KillipI级
右股骨近端动脉瘤样骨囊肿	股骨骨囊肿##动脉瘤性骨囊肿
右甲癌不全术后	甲状腺恶性肿瘤##癌##甲状腺术后
胃体前壁全层坏死伴穿孔	胃穿孔
淋巴继发恶性肿瘤	淋巴结继发恶性肿瘤
腓神经炎	单神经炎
糜烂性胃炎，异位胰腺	糜烂性胃炎##胰腺异位
右面部葡萄酒色斑	鲜红斑痣[葡萄酒色痣]
胃窦癌中分化腺癌	胃窦恶性肿瘤##腺癌
右肾囊肿多发性	肾囊肿
趾外翻	足畸形
上唇外伤性色素沉着	色素沉着未特指的疾患
胃癌T4N2M0III期	胃恶性肿瘤##癌
右手发麻待查桡神经病变	桡神经损害
主动脉瓣三尖瓣中度闭锁不全	主动脉瓣关闭不全##三尖瓣关闭不全
右前臂压疮皮缺损	压疮##上肢皮肤缺损
：小房缺；染色体病？	房间隔缺损##染色体病
右侧腹股沟斜疝成形术后	单侧腹股沟斜疝##腹股沟术后
顺产后宫内组织残留	胎盘部分残留不伴出血
外耳道腺样囊性Ca	腺样囊性癌##外耳道皮肤恶性肿瘤
20晚孕单活胎胎儿左心室强光点	妊娠状态
右肺小细胞癌广泛期	右肺恶性肿瘤##小细胞癌
双侧脑室及第三脑室形态扩大	脑室扩张
支气管炎恢复期	支气管炎
分娩伴会阴裂伤Ⅱ度	分娩伴会阴裂伤
右侧胸膜小圆细胞恶性肿瘤放化疗后	胸膜恶性肿瘤##恶性肿瘤放疗##化学治疗
右腘窝软组织伤	"下肢未特指的损伤,水平未特指"
子宫内膜癌术后 肺部结节不排除转移	子宫术后##子宫内膜恶性肿瘤##肺占位性病变##肺继发恶性肿瘤##癌
哮喘，植物神经功能紊乱	支气管哮喘##植物神经功能紊乱
视网膜动脉闭塞OD	其他视网膜动脉阻塞
额颞顶叶硬膜下积液低铁低锌	硬脑膜下积液##铁缺乏##锌缺乏
先天性心脏病室间隔缺损房间隔缺损肺高压	房间隔缺损##室间隔缺损##肺动脉高压
颈髓病变空洞可能性大	脊髓空洞症##脊髓病
肝功受损特纳综合症	特纳综合征[Turner综合征]##肝功能异常
异位肾伴旋转不良伴巨输尿管右侧	肾异位##先天性肾旋转不良##先天性巨输尿管
非霍奇金淋巴瘤(弥漫大B细胞型淋巴瘤 II期B组 IPI评分2分)	非霍奇金淋巴瘤##弥漫大B细胞淋巴瘤
左踝关节病变	关节病
左膝关节骨关节炎	单侧膝关节骨性关节病
左胸壁先天性鳃裂瘘管	鳃裂瘘
全身多处刀砍伤	刀砍伤加害
（左外耳道）鳞状细胞癌，中分化。	外耳道皮肤恶性肿瘤##鳞状细胞癌
纵膈淋巴组织细胞增生	淋巴组织增生
胆囊息肉伴慢性胆囊炎	胆囊息肉##慢性胆囊炎
非霍奇金血管免疫母细胞性T细胞淋巴瘤	非霍奇金淋巴瘤##血管免疫母细胞T-细胞淋巴瘤
腹腔室间隔综合症	腹腔筋膜室综合征[腹腔室隔综合征ACS]
左髋关节骨关节炎	髋骨关节病
右中叶MIA右下肺MIA	右肺中下叶恶性肿瘤##腺癌
骶尾部皮肤软组织广泛撕脱伴缺损	躯干开放性损伤##皮肤缺损
右面部软组织挫裂伤	面部软组织挫伤
摔伤头部	头部损伤##摔伤
"左乳癌术后,右下肺占位"	乳腺术后##癌##乳腺恶性肿瘤##肺占位性病变
右侧卵巢输卵管脓肿	输卵管卵巢脓肿
破碎的粘液变性的疏松结缔组织骨骼肌伴骨化	结缔组织病
发作性意识不清大小便失禁待查	尿失禁##大便失禁##意识模糊
颈椎间盘突出症伴椎管狭窄	颈椎间盘突出##颈椎管狭窄
左外侧突出型L45膨出	腰椎间盘突出
"胃癌，胃镜检查, 术后化疗呕吐肝功能障碍,慢性肝炎"	胃恶性肿瘤##恶性肿瘤术后化疗##呕吐##肝功能异常##慢性肝炎##癌
右腿麻软查因	肌无力
胼胝体异常信号影性质待定	"颅骨和头诊断性影像检查的异常所见,不可归类在他处者"
（右侧附件）符合卵巢卵泡膜细胞瘤，输卵管未见肿瘤。	卵巢良性肿瘤##泡膜细胞瘤
幽门管管状腺瘤	胃良性肿瘤##管状腺瘤
子宫内膜息肉术后	子宫内膜息肉##子宫术后
不自主抽动查因睡眠行为障碍	不自主运动##快动眼睡眠行为障碍
左肾盂癌	肾盂恶性肿瘤##癌
眼动脉畸形	周围动脉畸形
双肺内、第3胸椎、右髂骨转移不除外	肺继发恶性肿瘤##髂骨继发恶性肿瘤##胸椎继发恶性肿瘤##转移性肿瘤
左膝髌骨局灶性古梗死	骨坏死
双足青少年柔韧性平足全身松弛症	扁平足
双卵巢中分化腺癌	卵巢恶性肿瘤##腺癌
残角子宫查见胎盘及胎儿	残角子宫妊娠
宫颈中分化鳞癌IIB期化疗后	子宫颈恶性肿瘤##鳞状细胞癌##化学治疗
结肠癌术后，化疗后	结肠恶性肿瘤##癌##恶性肿瘤术后化疗
"胃癌,胃镜检查局麻 预防出血,超声胃镜检查"	胃恶性肿瘤##癌
上消化道出血(食道胃底静脉曲张)	上消化道出血##食管静脉曲张##胃底静脉曲张
宫颈鳞状细胞癌IIIB期化疗后	子宫颈恶性肿瘤##鳞状细胞癌##化学治疗
右侧第45前肋及第6后肋骨质破坏性质待查	骨质破坏
右口底导管囊性扩张伴钙盐沉积	钙质沉着症
膜性肾病不除外乙型肝炎病毒相关性肾炎	膜性肾病##乙型肝炎相关性肾炎
压力性尿失禁(轻度)	压力性尿失禁
面颊部肿物	面部肿物
停经245周B超提示胎儿上腔静脉走形迂曲	妊娠状态
海洛因海绵状白质脑病	海洛因中毒##脑白质病
窦性心律不齐窦房结内游走心律伴不齐	窦性心律失常##窦房结游走性心律
右肱骨大结节、肩胛盂骨折	肱骨大结节骨折##肩关节盂骨折
冠脉造影支架置入	冠状动脉支架植入术后状态
胸椎腰椎双侧髋关节退变脊柱轻度侧弯	胸椎退行性病变##腰椎退行性病变##双侧髋关节骨性关节病##脊柱侧弯
下腹部扭伤	身体未特指部位的脱位、扭伤和劳损
原发不输卵管性排卵异常	原发不孕##输卵管起因的女性不孕症
前庭大腺急性化脓性渗出物及增生的肉芽组织	前庭大腺脓肿[巴氏腺脓肿]
左腕豌豆骨撕脱性骨折	豆骨骨折
耳后粉瘤感染	皮脂腺囊肿##感染
眼植入物移位	其他眼假体装置、植入物和移植物的机械性并发症
病毒性肝炎慢性乙肝	慢性乙型病毒性肝炎
活体肝移植供体轻度脂肪肝	供肝脏者##脂肪肝
压缩性骨折(L1、L3)	腰椎压缩性骨折
急性淋巴细胞白血病(急性B淋巴细胞白血病)	急性淋巴细胞白血病##急性淋巴细胞白血病##B细胞急性淋巴细胞白血病
胃体Dieulafoy病	胃粘膜下恒径动脉破裂出血
低钙镁氯血症	低钙血症##低镁血症##低氯血症
纵隔鳞状细胞癌	纵隔恶性肿瘤##鳞状细胞癌
非酒精性脂肪肝病轻度	脂肪肝
左侧椎动脉动脉供血不足	椎-基底动脉供血不全
先天性肺动脉闭锁	肺动脉闭锁
左室心肌细胞呈弥漫性肥大改变部分变性	心肌肥大##心肌变性
左股骨近端溶骨性破坏	骨质溶解
肩手综合症	肩手综合征
右耳廓疤痕粘连伴部分缺损	瘢痕粘连##后天性耳廓缺损
先天性骨骼发育异常	骨骼发育不良
右侧颈总动脉粥样硬化斑块形成	颈总动脉斑块##颈动脉粥样硬化
左胫腓骨纤维异样增殖症	腓骨纤维结构不良##胫骨纤维结构不良
左肺上叶周围型腺癌cT1aN3M1 IV期左侧胸膜及叶间胸膜转移左侧恶性	左肺上叶恶性肿瘤##腺癌##胸膜继发恶性肿瘤##转移性腺癌##淋巴结继发恶性肿瘤
甲状腺癌伴肺M内放疗三程后	甲状腺恶性肿瘤##癌##肺继发恶性肿瘤##恶性肿瘤放疗##转移性癌
纤维蛋白原减少症	低纤维蛋白原血症
左侧小腿挤压软组织剥脱撕裂伤	小腿挤压伤##小腿撕脱伤
溃疡癌变	溃疡癌变
左附件交界性浆液性肿瘤术后	输卵管及卵巢恶性肿瘤
慢性纤维化空洞型肺结核伴支气管扩张	空洞型肺结核##结核性支气管扩张
右卵巢浆液性乳头状囊腺瘤	乳头状囊腺瘤##卵巢良性肿瘤
妊娠合并子宫浆膜下肌瘤	妊娠合并子宫肌瘤
结肠肿物术后	结肠肿物##结肠术后
颏部发育不足	先天性颅面发育不全
直肠癌姑息治疗后	直肠恶性肿瘤##姑息医疗##癌
肝硬变食管静脉曲张	肝硬化##食管静脉曲张
胃底胃体隆起性病变查因	胃和十二指肠未特指的疾病
左眼鸟枪弹样视网膜脉络膜病变	脉络膜未特指的疾患
朗格汉斯细胞增多症鞍区受累肺部浸润	朗格汉斯细胞组织细胞增生症
阑尾粪石嵌顿阑尾穿孔	阑尾结石##粪便嵌塞
脾错构瘤	脾错构瘤
1、冠心病心绞痛型心功能II级冠脉支架植入术后；	冠状动脉粥样硬化性心脏病##心绞痛##心功能Ⅱ级(NYHA分级)##冠状动脉支架植入术后状态
前纵隔占位，小细胞恶性肿瘤	前纵隔恶性肿瘤##小细胞型恶性肿瘤
颞骨发育畸形	锁骨颅骨发育不全
1枕部皮肤坏死伴缺损	头面部皮肤坏死##皮肤缺损
双下肢溃疡伴感染	下肢溃疡##下肢软组织感染
乳腺癌局部晚期化疗	乳腺恶性肿瘤##癌##恶性肿瘤终末期化疗
混合先露大小双	复合先露
卵巢良性肿物	卵巢肿物
前列腺放射性粒子植入术后	前列腺恶性肿瘤##恶性肿瘤放射性粒子置入治疗
肺恶性肿瘤;冠状动脉供血不足;高脂血症;肝肾阴虚	肺恶性肿瘤##冠状动脉供血不足##高脂血症
颅骨后天性缺损	后天性颅骨缺损
血吸虫病性肝硬化	血吸虫性肝硬化
多脏器功能不全累及脑循环心肝肾胃肠代谢	多脏器功能障碍综合征[MODS]
胆管癌：重度贫血	胆管恶性肿瘤##胆管癌##重度贫血
左前臂皮肤划伤清创缝合后	前臂开放性损伤##清创术后
宫颈癌IIIb期化疗后	子宫颈恶性肿瘤##化学治疗##癌
双眼泪道激光术后	眼术后
肝片吸虫抗体阳性	肝片吸虫病
二尖瓣主动脉瓣为钙化及玻璃样变的瓣	主动脉瓣钙化##二尖瓣钙化
腭部鳞状细胞癌	腭部恶性肿瘤##鳞状细胞癌
腰腿痛/心律失常/感冒	腰痛##下肢疼痛##心律失常##感冒
左膝关节占位性病变	下肢占位
先天被动免疫性血小板减少症	先天性血小板减少##免疫性血小板减少
宫颈低级别上皮内病变CINI级	子宫颈上皮瘤样病变[CIN]I级
肝损伤(肝功能损害)	肝损伤##肝功能异常
语言发育异常	言语和语言发育障碍
左胫腓骨骨折	腓骨骨折##胫骨骨折
增生的纤维结缔组织其内查见真菌	真菌感染
右乳癌综合治疗后肝	乳腺恶性肿瘤##癌
双膝关节髌上滑膜皱襞综合症	膝关节滑膜皱襞综合征
左腓肠神经断裂	神经断裂
颅内病变X刀治疗后	放射治疗
念珠菌感染	念珠菌病
糖尿病并血管病変	糖尿病
"颈椎病,颈项痛,腰腿痛"	颈椎病##颈痛##腰痛##下肢疼痛
梨状窝鳞状细胞癌	梨状窝恶性肿瘤##鳞状细胞癌
常规儿童健康检查卵圆孔未闭	卵圆孔未闭
宫颈中分化鳞癌Ⅱb期放疗后	子宫颈恶性肿瘤##鳞状细胞癌##恶性肿瘤放疗
左膝腓肠肌拉伤	小腿后部肌群和肌腱损伤
左眼白内障人工晶体植入术后	白内障##人工晶体植入状态
左手小指中节基底部陈旧性撕脱性骨折	指骨中节骨折##陈旧性指骨骨折
多发性子宫肌瘤伴玻璃样变性	子宫平滑肌瘤
右足肿物	足肿物
卵巢低分化浆液性癌	卵巢恶性肿瘤##浆液性癌
继发性重度骨髓再生功能障碍	继发性再生障碍性贫血
宫颈高级别病变CINIII级	子宫颈上皮内瘤变III级[CINIII级]
d副舟骨畸形右侧d	先天性足副舟骨
神经系统特指疾患肢体不自主抖动待查	"不自主运动##神经系统的其他疾患,不可归类在他处者"
原发性醛固酮增生症	原发性醛固酮过多症
支气管肺发育异常	先天性支气管发育不全##先天性肺发育不良
右侧中央型肺癌伴阻塞性肺炎	肺恶性肿瘤##阻塞性肺炎##癌
双肺间质改变双上肺多发点状影	肺部阴影
"胆囊切除术后,胆管结石,胆管炎,骨关节炎,行动不便"	胆囊术后##胆管结石##胆管炎##骨关节病
足部疼痛待查(平足症)	扁平足
升结肠中－高分化管状腺癌	管状腺癌##升结肠恶性肿瘤
高血压、LAD-AO瘘	高血压
结核性胸膜炎并胸腔积液	结核性胸膜炎##胸腔积液
双下肢过敏性水疱	下肢浅表水疱##过敏反应
左内踝关节囊肿	踝关节囊肿
"乳腺癌,化疗后骨髓抑制,药物性肝损伤,化疗呕吐 血肿,转氨酶升高 黄疸"	乳腺恶性肿瘤##化疗后骨髓抑制##药物性肝损害##化疗药物反应##呕吐##转氨酶升高##黄疸##癌
冠心病，缺血性心肌病，糖尿病，肾病	冠状动脉粥样硬化性心脏病##缺血性心肌病##糖尿病##肾病
右侧上颌多生埋伏牙	埋伏牙##多生牙
左足副舟骨左膝髌骨软化	髌骨软骨软化##先天性足副舟骨
先天性子宫附件缺如	先天性输卵管缺如##先天性卵巢缺如
患者踢足球时不慎被对方踢倒致伤左踝关节	踝关节损伤
慢性心功能不心功能Ⅱ-III级	心功能Ⅱ--Ⅲ级(NYHA分级)
右Hoffa骨折切口复位内固定后	股骨髁骨折
S2、T8及左第8后肋骨转移瘤	脊柱继发恶性肿瘤##O##肋骨继发恶性肿瘤##转移性肿瘤
1、肺部感染2、尿酸增高	肺部感染
急性粒细胞性白血病M2型缓解期	急性粒细胞性白血病部分分化型伴缓解(M2型)
其他d左前额裂伤d	前额开放性损伤
耳廓部分离断	耳廓开放性损伤
高尿酸高粘滞血症尿感	高粘稠血症##高尿酸血症
食管胃交界溃疡型混合型神经内分	食管胃连接部恶性肿瘤##神经内分泌癌
骨髓淋巴细胞增生	淋巴细胞增殖性疾病
双乳分叶状肿瘤	叶状瘤
妊娠急腹症	急腹症##妊娠状态
急性前壁心肌再梗死KillipⅢ级	急性前壁再发心肌梗死##KillipIII级
多发骨质破坏原因代谢性骨病氟骨病肿瘤	骨质破坏##氟骨症##性质未特指的肿瘤
全身多脏器功能衰竭心肝肾肺胰腺凝血肠道	凝血功能障碍##多脏器功能障碍综合征[MODS]
醣尿病肾功能轻度降低	未特指的糖尿病伴有肾的并发症
胰管分裂症	胰腺分裂症
右膝撞伤	"下肢其他特指的损伤,水平未特指"
结缔组织疾病相关性间质性肺疾病急性加重	结缔组织病##间质性肺病
骨肿瘤放疗	骨恶性肿瘤##恶性肿瘤放疗
左腓骨骨缺损骨不连	腓骨骨折不连接
左侧软腭裂伤	软腭开放性损伤
双侧颊部及牙龈扁平苔藓免疫异常	扁平苔癣##口腔扁平苔癣
右侧颈内透析隧道导管脱出	透析导管引起的机械性并发症
乙状结肠中分化腺癌伴肝转移术后（T3N1M1 D	乙状结肠恶性肿瘤##肝继发恶性肿瘤##腺癌##转移性腺癌
G2P1孕35+5周待产LOA妊娠合并胰腺炎	孕35周##妊娠合并急性胰腺炎
糖尿病合并血糖过低	糖尿病性低血糖症
左眼老年性湿性黄斑病变	老年性黄斑变性
直肠中低分化腺癌	直肠恶性肿瘤##腺癌
带状疱疹后综合征	带状疱疹
感染甲沟炎	甲沟炎
右前降支肌桥	冠状动脉肌桥
左眼视网膜脉络膜缺血性病变病	脉络膜缺血##视网膜动脉供血不足
女性不育症与宫角阻塞有关	子宫起因的女性不孕症
系统性红斑狼疮并狼疮性肾炎（V型）并血液系统损害	系统性红斑狼疮##狼疮性肾炎
胸12腰2腰4陈旧压缩改变	腰椎压缩性骨折##陈旧性腰椎骨折##胸椎压缩性骨折##陈旧性胸椎骨折##腰椎骨折L2##腰椎骨折L4
多动症.铅高	注意缺陷与多动障碍##铅中毒
包皮新生物	皮赘
系统性硬皮病并间质性肺疾病	间质性肺病##系统性硬化症性肺病变
胎儿完全性大动脉转位伴完整室间隔	完全型大动脉转位
尺桡骨折骨不连	尺骨骨折不连接##桡骨骨折不连接
右侧输卵管异位妊娠保守治疗后	输卵管妊娠
高血压性心脏损害2脑后循环缺血	高血压性心脏病##后循环缺血
急粒、乙肝3.3	急性粒细胞白血病##O
肿瘤标志物升高CEA	CEA升高##肿瘤标记物升高
淤血性脾肿大副脾	先天性副脾
全身多发转移癌复治	多部位继发恶性肿瘤##转移性癌
对角支轻微粥样硬化伴轻微狭窄	冠状动脉粥样硬化##冠状动脉狭窄
孕3产1宫内妊娠38周1天单活胎LOA	孕38周
脑动脉硬化脂肪肝	动脉硬化##脂肪肝
鼻咽低分化鳞癌放射治疗	鼻咽恶性肿瘤##鳞状细胞癌
心功能Ⅱ--Ⅲ级killip分期	KillipII级##KillipIII级
右侧耳后伤口愈合不良	开放性损伤愈合不良##耳部开放性损伤
右肾静脉压迫综合征[胡桃夹现象]	左肾静脉压迫综合征[胡桃夹现象]
宫颈CINI停经原因	子宫颈上皮瘤样病变[CIN]I级##停经
特发性斑疹毛细血管扩张	毛细血管扩张症##皮疹
右侧额部脑膜瘤	脑膜瘤
糖尿病足-右足感染	糖尿病足##感染
产前心脏病	未特指的心脏病
均小骨盆难产	均小骨盆引起的梗阻性分娩
卵巢颗粒细胞癌	卵巢恶性肿瘤##颗粒细胞癌
视网膜裂孔激光术后	视网膜裂孔##眼术后
右肺上叶小细胞癌伽玛刀治疗后化疗后	右肺上叶恶性肿瘤##小细胞癌##化学治疗##恶性肿瘤放疗
左前臂犬咬伤	被狗咬伤##前臂开放性损伤
左手中指掌指关节处包块	手肿物
免疫相关性白质脑病脑白质变性3级	脑白质病##自身免疫相关性脑病
左肩背部肿瘤	肩部肿瘤##背部肿瘤
乳腺癌 骨转移癌可能	乳腺恶性肿瘤##癌##骨继发恶性肿瘤##转移性癌
肝右外叶肝细胞癌	肝细胞癌##肝细胞癌
大便次数增多待查肛门潮湿	大便习惯改变
范博盖尔特脑白质病	脑白质病
双侧基底节区及脑桥腔隙灶深部脑白质缺血?	腔隙性脑梗死##基底节脑梗死##脑血管供血不足
扁平苔藓其他的	扁平苔癣
右隐睾包茎	单侧隐睾##包茎
左手中指皮肤割伤	手指开放性损伤
颈椎失稳症	颈椎不稳定
双下肢活动障碍原因待查脑血管疾病后遗症	运动障碍##脑血管病后遗症
椎管内病变伴截瘫	截瘫[双下肢瘫痪]
蝶鞍区脑膜良性肿瘤	脑膜良性肿瘤
右肺下叶局限性炎性病变	肺炎
"直肠癌 盆腔淋巴结转移,术前放化疗"	直肠恶性肿瘤##盆腔淋巴结继发恶性肿瘤##恶性肿瘤术前放疗##恶性肿瘤术前化疗##癌
工作时与小偷搏斗摔伤	工作中的意外损伤##摔伤
食管下段Barrett食管局灶轻度异型	巴氏食管
小肠癌史	小肠恶性肿瘤史
右髋关节破坏AS	强直性脊柱炎
左侧脑室脑膜瘤，WHO I级，皮细胞型。	脑室脑膜瘤
心肌肌桥	冠状动脉肌桥
血栓性混合痔	血栓性痔##混合痔
腺癌浸润	腺癌
胎盘部分滞留	胎盘部分残留不伴出血
双肾囊肿多发	肾囊肿
慢性浅表性胃炎并胃体糜烂	慢性浅表性胃炎##糜烂性胃炎
血液系统受累免疫相关性血小板减低	血小板减少
颌下腺腺泡轻度扩张符合涎石症	涎石病
肝内外胆管结石伴慢性胆管炎	慢性胆管炎##胆管结石
内侧关节室OA骨梗死	膝骨关节病##骨坏死
恶性肿瘤自体造血干细胞移植治疗	恶性肿瘤##自体造血干细胞移植状态
食管下段低分化鳞癌	食管下三分之一的恶性肿瘤##鳞状细胞癌
癌术后靶向治疗	恶性肿瘤术后靶向治疗##癌
双下肢行走异常	异常步态
肺部感染伴胸腔积液	肺部感染##胸腔积液
双下肢动脉粥样硬化闭塞症	下肢动脉粥样硬化闭塞症
右膝损伤术后	"下肢未特指的损伤,水平未特指"
非霍奇金淋巴瘤-弥漫大B细胞淋巴瘤-IV期B	非霍奇金淋巴瘤##弥漫大B细胞淋巴瘤
子宫内膜样腺癌伴鳞状上皮分化	子宫内膜样腺癌##子宫内膜恶性肿瘤
膜增 糖尿病肾病不除外	糖尿病性肾病
骨髓移植术后造血干细胞移植术后	骨髓移植术后##造血干细胞移植状态
慢性阻塞性肺疾病并肺部感染	慢性阻塞性肺疾病##肺部感染
胃肠间质瘤术后，贫血，白细胞减少	胃肠道间质性瘤##贫血##白细胞减少
多点取材仅见少量高度变性癌细胞胃壁全	胃恶性肿瘤##癌
胃癌术后高血压病	胃术后##胃恶性肿瘤##癌##高血压
左侧甲状腺腺瘤性伴囊性变	甲状腺良性肿瘤##腺瘤##甲状腺囊肿
右第1足趾远节趾骨撕脱性骨折	拇趾骨折
左肺上叶腺癌cT3N3M0 IIIB期（第八版） 化疗	左肺上叶恶性肿瘤##腺癌##化学治疗##淋巴结继发恶性肿瘤
B型预激综合症希氏束旁道	预激综合征[沃-帕-怀综合征]
右上肢肌肉组织慢性炎	肌炎
肝外中-低分化胆管腺癌	胆管腺癌
右肺下叶硬结灶双肺下叶间质改变	肺诊断性影像异常
高热惊厥可能4卵圆孔未闭	热性惊厥##卵圆孔未闭
右侧扁桃体鳞状细胞癌	鳞状细胞癌##扁桃体恶性肿瘤
新生儿细菌性脓毒症	新生儿未特指的细菌性脓毒症
右肺中分化鳞癌术后 右肺转移？	右肺恶性肿瘤##肺继发恶性肿瘤##鳞状细胞癌##转移性鳞状细胞癌
先天性喉哮鸣	先天性喉喘鸣
胎儿肺动脉反流心室强光点	肺动脉瓣关闭不全
发育不全	先天性发育异常
右肾癌不除外	肾恶性肿瘤##癌
纵隔淋巴结恶性肿瘤	未特指的淋巴结恶性肿瘤
动脉粥样硬化(颈动脉斑块)	颈动脉粥样硬化
子宫颈鳞癌放化疗后IIIB期	子宫颈恶性肿瘤##鳞状细胞癌##恶性肿瘤放疗##化学治疗
脑干小脑梗死多发性腔隙性脑梗死	小脑梗死##脑干梗死##多发性脑梗死##腔隙性脑梗死
双下肢麻痹待查低钾性周期麻痹	低钾型周期性瘫痪[低血钾性周期性麻痹/家族性周期性瘫痪]
": 阴道伤口息肉术后脱痂恢复期,宫颈鳞状细胞癌IIA2期伴HPV33型感染术后第二次化疗后,骨髓抑制,轻度贫血 ,阴道顶端恢复期,绝经综合征 ,阴道顶端肉芽增生"	阴道息肉##手术后恢复期##子宫颈恶性肿瘤##鳞状细胞癌##恶性肿瘤术后化疗##骨髓抑制##轻度贫血##更年期综合征##宫颈人乳头瘤病毒感染
右肾盂旁囊肿	肾盂囊肿
妊娠合并桥本氏甲状腺炎	自身免疫性甲状腺炎[桥本病]##妊娠状态
先天性鳃裂瘘管左侧先天性外耳道瘘管	鳃裂瘘##外耳道瘘
左足副舟骨源性平足症	先天性足副舟骨##扁平足
HIV感染	人类免疫缺陷病毒[HIV]病造成的多发性感染
厌氧菌感染	细菌感染
胎盘植入胎盘组织广泛退变坏死伴钙盐沉积	钙质沉着症##胎盘植入不伴出血
特指泌尿系疾病阴茎扭转	泌尿系统其他特指的疾患##阴茎未特指的疾患
额骨小骨瘤	额骨良性肿瘤##骨瘤
慢性肾脏病合并矿物质骨质代谢异常	慢性肾病##矿物质代谢紊乱
手术个人史左髂动脉支架成形术	周围血管支架植入术后状态
右肾造瘘口漏尿	肾造口状态
骨髓增殖性疾病原发性血小板增生性可能性大	骨髓增生性疾病##血小板增多
嗜酸细胞性支气管炎	支气管炎
带状疱疹？虫咬性皮炎？	带状疱疹##昆虫性皮炎##昆虫咬伤
1左先天性睑下垂2右下肢肌萎缩待查	先天性上睑下垂##下肢肌肉萎缩
甲状腺双侧叶乳头状癌	甲状腺乳头状癌##甲状腺恶性肿瘤
颈部及腰背刀伤	颈部开放性损伤##下背开放性损伤
发热(肺部感染?)	肺部感染##感染性发热
新生儿先天性心血管畸形	先天性心脏病
腰椎病变伴坐骨神经痛	坐骨神经痛##腰椎病
左肾静脉畸形	肾血管畸形
头皮色素瘤	头皮恶性黑色素瘤##恶性黑色素瘤
乙状结肠癌，肝转移，膀胱转移	乙状结肠恶性肿瘤##癌##肝继发恶性肿瘤##转移性癌##膀胱继发恶性肿瘤
中分化腺癌伴粘液腺癌	腺癌##粘液腺癌
睑缐炎	睑腺炎[麦粒肿]
早孕人流宫颈HPV58	早期人工流产##宫颈人乳头瘤病毒感染
左前降支中段心肌桥伴轻度狭窄	冠状动脉肌桥##冠状动脉狭窄
左足皮肤割伤	足部开放性损伤
腰僵三年强脊炎	强直性脊柱炎
急性坏疽穿孔性阑尾炎伴腹膜炎	急性坏疽性阑尾炎伴穿孔##急性坏疽性阑尾炎伴腹膜炎
陈旧性右室前壁心肌梗梗塞	陈旧性右心室心肌梗死##陈旧性前壁心肌梗死
范德伍德综合征	范德沃德综合征[VanderWoude综合征]
甲状腺双叶微小乳头状癌	甲状腺恶性肿瘤##乳头状微小癌
原发不孕纵膈子宫	子宫纵隔
右侧肾盂输尿管积水	输尿管积水##肾积水
右舌根鳞状细胞Ca	舌根恶性肿瘤##鳞状细胞癌
睾丸动态未定肿瘤	睾丸动态未定或动态未知的肿瘤
左腕部皮肤异物	腕部浅表异物
多发性子宫肌瘤	子宫多发性平滑肌瘤##子宫平滑肌瘤
胎儿异常胎儿融合肾	融合肾
双眼人工晶体植入状态左眼晶体移位	人工晶体脱位
宫颈癌IB3期	子宫颈恶性肿瘤##癌
右颈部淋巴结反应性增生	颈淋巴结肿大##淋巴结反应性增生
直肠乙状结肠结合部中分化腺癌术后 IV期化疗	直肠恶性肿瘤##乙状结肠恶性肿瘤##恶性肿瘤术后化疗##腺癌
气管造口状态(气管切开术后)	气管造口状态
全身淋巴结放化疗后	恶性肿瘤放疗##化学治疗##未特指的淋巴结恶性肿瘤
低度鳞状上皮内病变HPV高危型35阳性	人乳头瘤病毒感染
右侧慢性化脓性中耳乳突炎（骨疡型）	慢性化脓性中耳炎##慢性乳突炎##乳突骨疡
双乳纤维囊性乳腺病合并导管内乳头状瘤	乳腺良性肿瘤##乳房纤维囊性乳腺病##导管内乳头状瘤
丝虫性象皮病	丝虫性象皮肿
足趾关节肿痛	关节痛
全结肠切除术大便次数增多好转	大便习惯改变
左眼急性视网膜坏死	急性视网膜坏死综合征
热水烫伤右下肢	沸水烫伤##下肢烫伤
会厌鳞癌	会厌恶性肿瘤##鳞状细胞癌
妊娠性瘙痒症	瘙痒症##妊娠状态
双上肺继发性细支气管扩张	支气管扩张症
右肺癌放化疗后	右肺恶性肿瘤##化学治疗##恶性肿瘤放疗
颈腰椎病	颈椎病##腰椎病
左侧泌尿系结石碎石后，腰疼待查;	泌尿系结石##腰痛
外阴病毒感染	病毒感染##会阴部软组织感染
食管髓质型鳞状细胞癌	食管恶性肿瘤##鳞状细胞癌
冠心病不稳定性心绞痛，支架植入术后	冠状动脉粥样硬化性心脏病##不稳定性心绞痛##冠状动脉支架植入术后状态
子宫下段横切口剖宫产术	经未特指的剖宫产术分娩
1双侧小乳症2Tunner综合症	特纳综合征[Turner综合征]##先天性小乳
左侧下肢多发A-V瘘	动静脉瘘
慢性阻塞性肺部疾病急性发作期肺心病	慢性阻塞性肺疾病急性加重##肺源性心脏病
右乳导管内乳头状肿瘤性病变	乳腺良性肿瘤##导管内乳头状瘤
膝内翻轻度左侧肋外翻轻度	膝内翻##肋骨畸形
痉挛发作	痉挛
肺部感染-咯血	肺部感染##咯血
4.右小腿外伤伤口感染	小腿损伤##腿部感染
先天性左肾缺失	先天性肾缺如
腰椎间盘脱出伴脊髓病	腰椎间盘移位##脊髓病
肺卡氏孢子菌感染	卡氏肺孢子菌肺炎
直肠绒毛管状腺瘤伴表面局灶腺体高级别?	直肠良性肿瘤##管状绒毛状腺瘤
第五第六脑室形成发育变异	先天性第五六脑室
肝门区囊性病灶右肝低密度性质待查	肝囊肿
肝挫裂伤	肝挫伤##肝破裂
良性前列腺组织伴局部区域间质慢性炎	慢性前列腺炎
右上臂BOWEN病	上肢恶性肿瘤##鲍恩病
左足第4、5足趾间恶黑，左腹股沟、左髂血管淋巴结转移	足部恶性肿瘤##恶性黑色素瘤##腹股沟淋巴结继发恶性肿瘤##髂淋巴结继发恶性肿瘤
塑料锐物刺伤肛门	肛门损伤
低钾低氯待查	低钾血症##低氯血症
胸膜疾患	胸膜病变
周围神经病变右侧腋神经正中神经尺神经损害	多发性神经病[多发性神经炎/周围神经炎]##尺神经损害##正中神经损害##腋神经损伤
慢性阻塞性肺疾病急性加重期气管插管术后II型呼吸衰竭	慢性阻塞性肺疾病急性加重##气管术后##Ⅱ型呼吸衰竭
混合性肝细胞癌和胆管细胞癌	肝恶性肿瘤##肝胆管细胞癌
浅表心肌桥	冠状动脉肌桥
左臀部Bowen病	鲍恩病##臀部肿瘤
停经25周胎儿左手异常	孕25周
弥漫小肠及小肠系膜受累Ⅳ期2周期化疗后	肠系膜继发恶性肿瘤##化学治疗
原发性肝癌介入后##门静脉癌栓形成	肝恶性肿瘤##门静脉瘤栓##癌
双手麻木僵硬原因右膝OA	单侧膝关节骨性关节病
右上肢猫抓伤	猫抓病
左肺癌全身转移综合治疗后	左肺恶性肿瘤##广泛转移性肿瘤
腕部黑色素瘤	上肢恶性黑色素瘤
胃幽门癌	幽门恶性肿瘤##癌
G3P1孕39周已产ROA	正常分娩
胃窦低分化腺癌术后（T4N3M1，Ⅳ期）	胃术后##胃窦恶性肿瘤##腺癌
右上唇基底细胞癌	基底细胞癌##上唇恶性肿瘤
甲白斑角质松解症	"白斑病,不可归类在他处者##剥脱性角质松解症"
急性脑梗死左颞叶枕叶大面积梗塞	大面积脑梗死##脑梗死##多发性脑梗死
右侧先天性手指侧弯	先天性指畸形
急性移植物抗宿主反应病胃肠道	急性移植物抗宿主病
"食管鳞癌 咳嗽,肺部感染,胃炎"	食管恶性肿瘤##鳞状细胞癌##咳嗽##肺部感染##胃炎
周围神经病变壶腹部十二指肠壁导管异位	多发性神经病[多发性神经炎/周围神经炎]##十二指肠异位胰腺
直肠中分化粘液腺癌根治术后(pT4bN1M0)IIIC期化疗	直肠术后##直肠恶性肿瘤##粘液腺癌##恶性肿瘤术后化疗##淋巴结继发恶性肿瘤
胃角早期carcinoma	胃恶性肿瘤##癌
肠系膜区局限性异常密度影	腹部诊断性影像异常
肝、骨转移癌介入治疗	肝继发恶性肿瘤##骨继发恶性肿瘤##恶性肿瘤介入治疗##转移性癌
左眼白内障术后	白内障##眼术后
右足跟陈旧骨折伴骨质疏松	陈旧性跟骨骨折##骨质疏松
"G4PO孕28+W待产ROA,产前出血原因待查?胎儿位置异常"	孕28周##产前出血
前躯干、右上肢热水烫伤	躯干部烫伤##上肢烫伤
皮肤包块	皮肤肿物
急性淋巴细胞白血病维持化疗	急性淋巴细胞白血病##急性淋巴细胞白血病##化学治疗
脑膜瘤(术后)	脑膜瘤##脑术后
双眼屈光不正（远视 远视散光）	屈光不正##远视##散光
严重脓毒血症并多脏器功能不全	脓毒症##多脏器功能障碍综合征[MODS]
双侧卵巢中低分化浆液性乳头状腺癌	卵巢恶性肿瘤##乳头状浆液性腺癌
主动脉弓粥样斑块形成并管腔轻度狭窄	主动脉弓狭窄
胃肠动力低下	胃肠功能紊乱
带环出血冠心病	放置子宫内避孕装置##出血##冠状动脉粥样硬化性心脏病
浮肿待查1心源性浮肿2营养性	水肿##营养性水肿
急性粒细胞性白血病M2型	急性粒细胞性白血病部分分化型(M2型)
血白细胞升高原因头昏原因双眼浮肿原因	白细胞增多##眼睑水肿##头晕
荨麻疹，胃肠型	胃肠型荨麻疹
胃窦粘液腺癌	胃窦恶性肿瘤##腺癌
右前臂尺神经血管断裂	血管断裂
掌骨骨折(术后)	掌骨骨折##骨折术后
冠心病心律失常型;高血压;慢性喘息性支气管炎;高血压性肾病	冠心病心律失常型##高血压##O##高血压性肾病
肺粘液腺癌	肺恶性肿瘤##粘液腺癌
左侧肩背外伤痛	"肩部损伤##躯干未特指的损伤,水平未特指##肩痛##背痛"
剖宫产后，低热	经未特指的剖宫产术分娩##发热
肝血管瘤;胸痹心痛病;气血不足证;	肝血管瘤
类风湿关节炎肾损害	类风湿性关节炎##慢性肾损害
慢性肾衰竭尿毒症期CKD5期痛风性肾病	"慢性肾脏病,5期##痛风性肾病"
右上臂截肢后残端骨质过度生长	截肢
大、小网膜及胃壁多发淋巴结转移	多部位淋巴结继发恶性肿瘤
脑底血管环发育变异	脑血管畸形
右环指玻璃划伤	手指开放性损伤##玻璃割伤
停经283周B超提示胎儿右侧腹部无回声区	妊娠状态
左臀部带状疱疹后遗神经症	带状疱疹后遗症##神经症性障碍
左胸壁转移术后	胸壁继发恶性肿瘤##转移性肿瘤
胸12腰1椎体后缩性骨折	胸椎压缩性骨折##腰椎骨折L1##腰椎压缩性骨折
双卵巢低分化浆液性腺癌	卵巢恶性肿瘤##浆液性腺癌
右乳头糜烂待查1右乳pagtes病	乳头恶性肿瘤##乳房佩吉特病
不育待查重度弱精子症	男性不育症##男方弱精症
肝癌，化疗后血细胞低下	肝恶性肿瘤##化疗药物反应##全血细胞减少##癌
前列腺ca术后多发骨转移	前列腺恶性肿瘤##癌##前列腺术后##骨继发恶性肿瘤##转移性癌
左乳多发性导管扩张及大汗腺化生	乳腺导管扩张症
酒精性精神病	酒精所致的精神病性障碍
交界性先天性大疱性表皮松解症	交界型大疱性表皮松解症
主动脉瓣四瓣化伴中度关闭不全	主动脉瓣关闭不全##先天性主动脉瓣畸形
双眼眼裂缩窄	睑裂狭小
菌痢	未特指的细菌性痢疾
慢性中耳炎(胆脂瘤)	中耳胆脂瘤##慢性中耳炎
右鼻腔新生物Ca	鼻腔恶性肿瘤##癌
右肺中叶外侧段肺组织膨胀不全	肺不张
停经293周B超提示胎儿鼻骨显示不清	妊娠状态
肾错构瘤破裂出血	肾错构瘤破裂出血
"冠心病,心绞痛型"	冠状动脉粥样硬化性心脏病##心绞痛
糖尿病性酮酸中毒	糖尿病性酮症酸中毒
肝脏肝细胞弥漫性脂肪变性及水样变性	脂肪肝
全身炎症反应性综合症	全身炎症反应综合征
基底节多发腔隙性脑梗死	腔隙性脑梗死##基底节脑梗死##多发性脑梗死
右侧臀部截瘫后褥疮	未特指的截瘫##压疮
右膝软组织裂伤	下肢撕裂伤
自身免疫特征的肺间质病变	其他间质性肺疾病
甲状腺癌术后复发并气管内侵犯	甲状腺术后##甲状腺恶性肿瘤##气管继发恶性肿瘤##癌##恶性肿瘤复发
双颈动脉粥样硬化症	颈动脉粥样硬化
左肺下叶癌术后5年余，复诊	肺术后##左肺下叶恶性肿瘤##癌
十二指肠壶腹周围癌	法特壶腹周围恶性肿瘤##癌
肝右叶肝细胞癌M81700/32	肝细胞癌
左舌癌术后复发	舌术后##舌恶性肿瘤##癌##恶性肿瘤复发
复诊T11-12髓内囊肿保守治疗中	脊髓内囊肿
双侧颈部及颅内动脉多发斑块及狭窄	动脉狭窄##颈动脉狭窄
急性移植物抗宿主反应病Ⅲ度皮肤肝脏肠道	急性移植物抗宿主病
乙状结肠中分化腺癌	乙状结肠恶性肿瘤##腺癌
右眼眶鼻窦病变待查右上颌骨部分缺失	颌骨缺损
右下肢浅静脉曲张术后	下肢静脉曲张##静脉曲张术后
右膝关节髌下脂肪垫卡压综合症	髌骨后脂肪垫综合征[Hoffa综合征]
NKT细胞淋巴瘤	结外NK/T细胞淋巴瘤(鼻型)
梗死KillipII级陈旧性正后壁	KillipII级##陈旧性正后壁心肌梗死
脐茸	脐茸
T椎体陈旧性压缩性骨折	陈旧性胸椎骨折##胸椎压缩性骨折
弥漫性实质性肺疾病特发性间质性肺纤维化	弥漫性肺间质疾病##特发性肺间质纤维化
腋窝皮脂腺囊肿	皮脂腺囊肿
左足透明细胞肉瘤反复复发术后	足部恶性肿瘤##透明细胞肉瘤##恶性肿瘤复发
汗腺孔癌	汗腺恶性肿瘤##癌
乙状结肠管状腺癌术后	乙状结肠恶性肿瘤##管状腺癌##结肠术后
肝内外胆管结石伴胆管炎	胆管结石伴胆管炎
2马尾神经不全损伤	马尾损伤
水肿蛋白尿待查	水肿##蛋白尿
右乳增生病伴纤维腺瘤	乳腺良性肿瘤##纤维腺瘤##乳腺增生
结肠管状腺瘤伴低级别上皮内瘤变	结肠良性肿瘤##管状腺瘤
口咽粘膜擦伤	口腔和咽喉部损伤
喉中低分化鳞状细胞癌	喉恶性肿瘤##鳞状细胞癌
肠梗阻-便秘？	肠梗阻##便秘
皮肤色素沉着原因1Addison病2其他	色素沉着未特指的疾患##艾迪生病[Addisons病]
鼻后滴漏综合征	鼻窦滴漏综合征
多发性肝胆管囊肿	胆管囊肿
输卵管腺癌	输卵管恶性肿瘤##腺癌
中度慢性浅表性胃炎伴局灶腺体肠上皮化生	慢性浅表性胃炎##肠上皮化生
右乳腺病伴导管扩张症及大汗腺化生	乳房未特指的疾患##乳腺导管扩张症
钢缆打伤左膝关节	膝关节损伤
食管胃交界癌。。。。。。	食管胃连接部恶性肿瘤##癌
右侧乳腺纤维瘤切除术后	乳腺术后##乳腺纤维瘤
左肩峰下撞击征左肩袖断裂左肩继发性冻	肩撞击综合征##肩袖肌腱损伤
先天性关节脱位	身体未特指部位的脱位、扭伤和劳损
肠癌 高血压 糖尿病（去外地带药）	肠道恶性肿瘤##高血压##糖尿病##癌
右侧髌骨骨折术后	髌骨骨折##骨折术后
右颞软化己脑后遗症	脑软化
肝内胆汁淤积性黄疸	黄疸
左顶枕骨瘤	骨瘤##枕骨良性肿瘤##顶骨良性肿瘤
小乳症鞍鼻	先天性小乳##鞍鼻
动脉粥样硬化斑块形成狭窄	动脉粥样硬化
停经34周MR提示胎儿骶尾椎排列紊乱	孕34周
左侧胸壁先天性鳃裂瘘管	鳃裂瘘
右侧乳腺癌放疗后	乳腺恶性肿瘤##恶性肿瘤放疗##癌
右下肢腘动脉血栓栓塞	腘动脉血栓形成##腘动脉栓塞
右侧冈上肩胛下肌腱退变部分撕裂	肩胛下肌肌腱损伤
"左乳腺癌术后,骨转移,肺转移,严重骨质疏松"	乳腺术后##乳腺恶性肿瘤##癌##骨继发恶性肿瘤##肺继发恶性肿瘤##转移性癌##重度骨质疏松
慢性风湿性心脏病	风湿性心脏病
右膝后交叉韧带损伤	膝关节后十字韧带损伤
肠套叠回肠-升结肠套叠	肠套叠
下段胸骨及伤口愈合不良	开放性损伤愈合不良
膀胱移行上皮癌	膀胱恶性肿瘤##癌
急性肠穿孔回肠病变性质待定	肠穿孔
Rett综合征	雷特综合征[Retts综合征][脑萎缩性高血氨症]
"疼痛 药物过敏性皮疹,左肺腺癌IV期,上呼吸道感染，咳嗽"	疼痛##药物过敏性接触性皮炎##左肺恶性肿瘤##腺癌##上呼吸道感染##咳嗽
先天性小齿状突寰枢椎不稳合并脊髓压迫	颈椎不稳定##脊髓压迫症
宫颈差分化癌	子宫颈恶性肿瘤##癌
"乳癌术后骨转移 严重骨质疏松 ,肝损伤癌性疼痛"	乳腺术后##乳腺恶性肿瘤##骨继发恶性肿瘤##重度骨质疏松##肝损伤##癌性疼痛##癌##转移性癌
右上肢肌萎缩待查	肌肉萎缩
子宫颈鳞癌联合治疗后的随诊检查	子宫颈恶性肿瘤##鳞状细胞癌##恶性肿瘤联合治疗后的随诊检查
右乳4点管状腺瘤	乳腺良性肿瘤##管状腺瘤
右 乳腺癌 ？	乳腺恶性肿瘤##癌
急慢性炎伴淋巴组织增生	淋巴组织增生
痹证;骨关节病(两种膏药错开使用)；肝热便秘	骨关节病##便秘
高血压3期	高血压
右额颞顶部慢性硬膜下积液	硬脑膜下积液
右乳头乳晕Paget's病	乳房佩吉特病##乳晕恶性肿瘤##乳头恶性肿瘤
隆突性皮肤纤维肉瘤	隆凸性皮肤纤维肉瘤
胸椎破坏伴截瘫	截瘫[双下肢瘫痪]
三尖瓣环发育欠佳	三尖瓣发育异常
MODS心功能肾功能凝血功能	多脏器功能障碍综合征[MODS]
慢性移植物抗宿主反应病胃肠道口腔	慢性移植物抗宿主病
左手背皮肤软组织撕脱并缺损	手部开放性损伤##皮肤缺损
右乳错构瘤	乳房错构瘤
肺大泡切除术后	肺大疱##肺术后
肝内多发占位与肝硬化	肝硬化##肝占位性病变
肝硬化食管胃底静脉曲张破裂出血	肝硬化伴食管静脉曲张破裂出血
急性脑梗死右侧颞顶枕叶梗死	脑梗死##多发性脑梗死
右附件囊性病变-输卵管结积液可能	输卵管卵巢囊肿##右侧输卵管积水
双眼睑多发性化脓性肉芽、霰粒肿	眼睑肉芽肿##化脓性肉芽肿##睑板腺囊肿[霰粒肿]
肠激惹综合症（过敏性肠综合症）	肠易激综合征
肾实质萎缩囊性变肾皮质部分肾小球玻璃	肾囊肿##肾萎缩
股四头肌腱及髌韧带部分撕裂	髌韧带损伤##股四头肌肌腱损伤
慢性肾脏疾病合并矿物质骨代谢异常	矿物质代谢紊乱##肾小球内皮细胞病
腰1-4右侧横突骨折	腰椎多发性骨折
急性ST段抬高型前间壁心肌梗死	急性前间壁心肌梗死##急性ST段抬高型心肌梗死
气管癌	气管恶性肿瘤##癌
右乳小叶增生伴纤维腺瘤	乳腺良性肿瘤##纤维腺瘤##乳腺增生
肌酶升高待查：系统性红斑狼疮？肌炎？	系统性红斑狼疮##肌炎
绝经后IUD断裂嵌頓肌层内外院取环失败后	避孕环残留##避孕环嵌顿
双乳纤维腺瘤合并纤维囊性乳腺病	乳腺良性肿瘤##纤维腺瘤##乳房纤维囊性乳腺病
双眼高眼压左眼散粒肿	高眼压症##睑板腺囊肿[霰粒肿]
老年性脑改变粥样硬化	脑动脉粥样硬化##老年性脑变性
"化疗呕吐失眠,小细胞肺癌化疗脑转移癌,白细胞减少抗凝,行动不便便秘高血压,行动不便过敏肝功能异常,反流性食道炎伴溃疡便秘,重度疼痛抗过敏水肿利尿"	化学治疗##呕吐##失眠##肺恶性肿瘤##小细胞癌##脑继发恶性肿瘤##化学治疗##白细胞减少##便秘##高血压##肝功能异常##反流性食管炎##食管溃疡##疼痛##水肿##转移性小细胞癌
胃平滑肌瘤	平滑肌瘤##胃良性肿瘤
鼻咽右侧壁未分化型非角化性癌	鼻咽侧壁恶性肿瘤##未分化的癌
铅高多动	铅中毒##注意缺陷与多动障碍
肠胃功能失调	胃肠功能紊乱
G4P2孕33+5周宫内妊娠	孕33周
头昏反复发作左肢麻木无力	肢体无力##头晕
脾区管状腺瘤低级别	管状腺瘤##脾良性肿瘤
无精症睾丸生精障碍	无精子症##睾丸功能障碍
"乳腺癌术后,晚期绝经后"	乳腺术后##乳腺恶性肿瘤##癌
病态窦性综合征	病态窦房结综合征
特指手术后状态(左下肢大隐静脉高位结扎术后)	其他特指的手术后状态
多关节退变手膝髋关节并周围神经病变	骨关节病##多发性神经病[多发性神经炎/周围神经炎]
中度听力损害	听功能障碍
纵隔畸胎瘤术后伴多发骨转移	纵隔恶性肿瘤##恶性畸胎瘤##骨继发恶性肿瘤##转移性畸胎瘤
剑突下疼痛待查;心肌梗死;	剑突下疼痛
双前臂多处软组织被铁片划伤	前臂开放性损伤
移植肾慢性排异反应伴有部分肾坏死	肾移植排斥
乳牙外伤	牙及相关组织损伤
膀胱癌(高级别尿路上皮癌)	尿路上皮癌##膀胱恶性肿瘤
手术分娩骶左前位活小婴	无指征剖宫产的单胎分娩
骶尾部穿透伤	骨盆开放性损伤
左侧矢状窦旁、小脑幕脑膜瘤	矢状窦旁脑膜瘤##小脑慕脑膜瘤
腓总神经炎	下肢单神经炎
冠心病、高血压、贫血？	冠状动脉粥样硬化性心脏病##高血压##贫血
右足烧伤后瘢痕挛缩畸形	瘢痕挛缩##足部瘢痕
副乳癌	副乳腺恶性肿瘤##癌
妊娠合并肝血管瘤	肝血管瘤##妊娠状态
右乳腺癌维持性化学治疗	乳腺恶性肿瘤##恶性肿瘤维持性化学治疗##癌
口腔血管瘤	口腔血管瘤##血管瘤
胸11-12椎间隙异常信号影	其他特指身体结构诊断性影像检查的异常所见
原发性支气管肺癌(左上肺 鳞癌可能 cT4N0M1(骨 )	左肺上叶恶性肿瘤##鳞状细胞癌##骨继发恶性肿瘤##转移性鳞状细胞癌
慢性主观性头昏自主神经功能不全	自主神经功能紊乱##头晕
脱髓鞘病变左侧桥脑臂	脱髓鞘性脑病
WERNICKE脑病	韦尼克失语症[Wernicke失语症]
颈髓脱髓鞘病变焦虑合并抑郁	脱髓鞘病##抑郁状态##焦虑状态
冠心病高血压骨关节病	冠状动脉粥样硬化性心脏病##高血压##骨关节病
子宫粘膜下平滑肌瘤	子宫粘膜下平滑肌瘤##子宫平滑肌瘤
原发性不孕-输卵管因素	原发不孕##输卵管起因的女性不孕症
"糖尿病,冠状动脉粥样硬化,糖尿病伴神经并发症,2型糖尿病性周围血管病变"	糖尿病##冠状动脉粥样硬化##糖尿病伴神经系统并发症##2型糖尿病性周围血管病
右腮腺囊性水瘤	囊性淋巴管瘤##腮腺淋巴管瘤
宫颈鳞状上皮内瘤变III级	子宫颈上皮内瘤变III级[CINIII级]
腹水原因待查肝硬化性腹水可能性大	腹水##肝硬化
中毒性产后心肌炎	中毒性心肌炎
慢性肝炎活动性肝炎	慢性活动性肝炎
前降支次全闭塞右冠和左旋支高度狭窄	冠状动脉狭窄##冠状动脉闭塞
左足踝部软组织坏死缺如	足坏死
停经251周B超提示胎儿颈后无回声	妊娠状态
粒细胞缺乏伴上呼吸道感染	粒细胞缺乏##上呼吸道感染
异位垂体	垂体异位
"双肺多发结节,左乳腺癌术后"	肺占位性病变##乳腺术后##乳腺恶性肿瘤##癌
中耳长肠虫症	寄生虫病
胃低-中分化腺癌	胃恶性肿瘤##腺癌
左手多处皮肤划伤	多处皮肤浅表损伤##手部损伤
左下肢梭形细胞恶性肿瘤	下肢恶性肿瘤##梭形细胞型恶性肿瘤
C6D67颌面沟窝色素沉着	色素沉着未特指的疾患
多脏器功能不全肾脑心代谢凝血	多脏器功能障碍综合征[MODS]
感染(伤口)	开放性损伤伴感染
鼻咽癌肺转移、骨转移术后	鼻咽恶性肿瘤##癌##骨继发恶性肿瘤##转移性癌
子宫膀胱脱垂	子宫阴道脱垂##膀胱粘膜脱垂
右下肢慢性静脉功能不全并瘀积性皮炎	下肢静脉功能不全##淤积性皮炎
肾脏错构瘤	肾错构瘤
卵巢癌 第七次化疗后	卵巢恶性肿瘤##癌##化学治疗
成骨不全(骨脆症)	成骨不全[脆骨病]
开放性腕和手多发损伤	腕和手多处开放性损伤
先天性上脸下垂	先天性上睑下垂
继发性凝血障碍维生素K依赖性	凝血功能障碍##维生素K缺乏
硬化性肾小球肾炎	硬化性肾炎
子宫内膜增生子宫内膜单纯性增生	子宫内膜单纯性增生
右侧上颌骨骨纤维异样增殖症	颌骨纤维异常增殖症
失代偿性呼吸性合并代谢性酸中毒	代谢性酸中毒##呼吸性酸中毒
右乳浸润性导管癌改良根治术后Ⅲa期（ypT1N2M0）化疗	乳腺恶性肿瘤##乳腺术后##浸润性导管癌##恶性肿瘤术后化疗##淋巴结继发恶性肿瘤
右足良性骨肿瘤	骨良性肿瘤##足部良性肿瘤
阑尾腺癌	阑尾恶性肿瘤##腺癌
右眼炮崩伤	爆竹炸伤
右上肢尺桡骨折	桡骨骨折##尺骨骨折
先天性胆道扩张	先天性胆管扩张
化脓性脑膜炎恢复期	脑膜炎恢复期
疣状血管瘤	血管瘤
手神经受伤	腕和手神经损伤
创伤后头痛	头痛
酒精火焰烧伤双上肢	上肢烧伤##火焰烧伤
腺泡状横纹肌肉瘤	软组织腺泡状肉瘤##横纹肌肉瘤
前列腺结节状增生伴间质慢性炎	前列腺增生##慢性前列腺炎
腹痛(未特指);肠癌术后	腹痛##胃肠道恶性肿瘤##癌
右侧结节性甲状腺肿伴囊性变	结节性甲状腺肿
右髋臼边缘骨质破坏待查撞击综合征	骨质破坏##髋关节撞击综合征
左侧眉弓软组织挫裂伤	眉弓挫伤##眉弓裂伤
隐匿性精子症染色体核型异常遗传性	未特指的染色体异常##隐匿性无精子症
非感染性急性1血液系统疾病2风湿性疾病	风湿病
胃角溃疡型低分化腺癌	胃恶性肿瘤##腺癌
右眼睑损伤	眼睑和眼周区其他浅表损伤
女性中肾管囊肿	女性中肾管囊肿
感音神经性听觉减退老年性听损	老年性聋##感音神经性聋
无精症输精管梗阻精液淤积症	无精子症##输精管梗阻##附睾精索精子淤积症
腰1椎体压缩性骨折	腰椎压缩性骨折
心律失常-I°房室传导阻滞	一度房室阻滞##心律失常
右足外侧皮肤缺血坏死	下肢皮肤坏死##下肢供血不足
腹部左大腿打伤	腹部损伤##大腿损伤
淋巴结Castelman病	Castleman病
右乳肿物:癌	乳房肿物##乳腺恶性肿瘤##癌
自身免疫性甲状腺病甲状腺病甲功正常期	其他特指的甲状腺疾患
右颊粘膜舌尖及下唇扁平苔藓	口腔扁平苔癣##舌扁平苔癣
心功能肌缺血IV级	心功能IV级(NYHA分级)
低钾低钠低氯血症	低钠血症##低钾血症##低氯血症
腕手部肌肉和肌腱扭伤	腕和手肌肉和肌腱损伤
高血压冠心病关节炎牙痛	高血压##冠状动脉粥样硬化性心脏病##关节炎##牙痛
右姆趾远节基地部骨折	拇趾骨折
脑干血管畸型	脑血管畸形
脑转移瘤切除术后	脑继发恶性肿瘤##转移性肿瘤##脑术后
舌咽神经炎	单神经炎
胃癌不除外	胃恶性肿瘤##癌
哮喘、气管炎复诊	支气管哮喘##气管炎
膀胱Ca	膀胱恶性肿瘤##癌
抑郁性神经症植物神经给你紊乱	恶劣心境##植物神经功能紊乱
骨质疏松抽筋	骨质疏松
肾小球轻微病变伴高血压肾损害	高血压肾损害##肾小球微小病变
残冠1##124————##————根尖牙周炎3##————##————	根尖周炎
无力性脚感觉异常症	不安腿综合征[不宁腿综合征]
动物伤	动物咬伤或造成损伤
多发陈旧性闹梗塞	多发性脑梗死##陈旧性脑梗死
肿标升高待查全麻胃肠镜丙泊酚不耐受	肿瘤标记物升高
直肠癌PT4N0M0II期	直肠恶性肿瘤##癌
慢性肉芽肿性炎	肉芽肿
支扩伴感染胸水	支气管扩张症合并感染##胸腔积液
全子宫切除术2年余发现附件囊肿1年	输卵管卵巢囊肿##子宫术后
周围神经癌	周围神经和自主神经系统恶性肿瘤##癌
肿标增高待查十二指肠隆起型病变	肿瘤标记物升高
前次手术后子宫瘢痕	子宫术后##瘢痕子宫
右侧尿路结石术后	泌尿系结石##尿道术后
哺乳期右乳头糜烂paget'病	乳腺皮肤恶性肿瘤##乳房佩吉特病
重度周围神经病变以轴索改变为主	轴索性周围神经病
狼疮相关性肺动脉高压	红斑狼疮##肺动脉高压
浮肿体液代谢不调月经不调	水肿##月经紊乱
右腮腺腺泡细胞癌	腮腺恶性肿瘤##腺泡细胞癌
肝细胞腺瘤	肝细胞腺瘤##肝良性肿瘤
门静脉高压症：食管胃底静脉曲张、脾大	门静脉高压##食管静脉曲张##胃底静脉曲张##脾大
表皮下水疱	身体浅表水疱
甲状腺左叶乳状ca术后局部复发	甲状腺恶性肿瘤##甲状腺乳头状癌##甲状腺术后##恶性肿瘤复发
慢性粒单核细胞白血病	慢性粒单核细胞性白血病
左侧腹直肌拉伤	腹部、下背和骨盆肌肉和肌腱损伤
基底动脉脑梗死心源性	脑梗死
腰3椎体缩性骨折伴骨髓受压	腰椎压缩性骨折##脊髓受压
多发腔隙性脑梗死灶	多发性脑梗死##腔隙性脑梗死
骨髓增生明显活跃单核样细胞数量明显增多	单核细胞增多
慢性肾脏病2期肾病综合征膜性肾病Ⅰ期	"慢性肾脏病,2期##肾病综合征##膜性肾病"
心脑缺血	脑血管供血不足##心肌供血不足
胸椎疼痛	疼痛
左耳听觉障碍	听功能障碍
慢性粒单核细胞白血病转急性白血病	慢性粒单核细胞白血病##急性白血病
颈椎损伤伴不全瘫	不完全性瘫痪##脊柱损伤
ll型糖尿病	2型糖尿病
淋巴结继发癌	淋巴结继发恶性肿瘤##继发性癌
肝Ca肝硬化乙肝	肝恶性肿瘤##癌##肝硬化##O
中毒性多发性周围神经病	多发性神经病[多发性神经炎/周围神经炎]
右足右侧腓骨下缘撕脱性骨折伴脱位	腓骨骨折##腓骨脱位
多脏器功能障碍呼吸循环肾脏消化血液凝血	多脏器功能障碍综合征[MODS]
MR示胸4椎体水平脊髓后方异常信号影	其他特指身体结构诊断性影像检查的异常所见
双下肢无力原因待查腰椎病所致可能性大	肢体无力##腰椎病
"左肾透明细胞癌术后,慢性肾功能不全"	肾术后##肾恶性肿瘤##透明细胞癌##慢性肾功能不全
右舌高分化鳞状细胞癌	舌恶性肿瘤##鳞状细胞癌
"右肾透明细胞癌术后,腹腔及腹壁转移"	肾术后##肾恶性肿瘤##透明细胞癌##腹腔继发恶性肿瘤##转移性癌
左额顶叶脑挫裂伴血肿形成	多发性大脑挫裂伤##多发性大脑血肿
左膝关节软组织挤压伤	膝部挤压伤
横结肠癌	横结肠恶性肿瘤##癌
"尿毒症;肾性贫血;周围神经病;冠心病心律失常型;高血压;肾性贫血,高脂血症;原发性甲状腺机能减退"	尿毒症##肾性贫血##多发性神经病[多发性神经炎/周围神经炎]##冠心病心律失常型##高血压##肾性贫血##高脂血症##原发性甲状腺功能减退
冠心病冠脉支架置入术后	冠状动脉粥样硬化性心脏病##冠状动脉支架植入术后状态
全身化疗后	化学治疗
先天性脊髓栓系综合征	脊髓栓系综合征
右眼全周房角劈裂后退	外伤性前房角劈裂##前房后退[房角后退]
糖尿病反复低血糖严重并发症	糖尿病性低血糖症
脊髓发育不全	脊髓发育不良
右肺穿刺活检腺癌	右肺恶性肿瘤##腺癌
颈椎腰椎间盘膨出症	腰椎间盘移位##其他的颈椎间盘移位
霍其金氏淋巴瘤化疗后	霍奇金淋巴瘤##化学治疗
升结肠腺癌维持性化学治疗	升结肠恶性肿瘤##腺癌##恶性肿瘤维持性化学治疗
外源性肺泡炎	过敏性肺炎[外源性过敏性肺泡炎]
肠肌惹综合症	肠易激综合征
软骨钙沉着其他的	软骨钙质沉着病
胃贲门溃疡型中分化腺癌	贲门恶性肿瘤##腺癌
心境障碍-双相障碍	心境[情感]障碍##双相情感障碍
左肘关节肱骨外侧髁陈旧撕脱性骨折	肱骨外髁骨折##陈旧性肱骨骨折
新生儿右足外翻畸形	先天性足畸形
外阴阴道赘生物	外阴息肉##阴道息肉
中段食管癌	食管中三分之一的恶性肿瘤##癌
右眼皮肤擦伤	眼睑和眼周区其他浅表损伤
右肺中叶癌术后，失眠焦虑	肺术后##右肺中叶恶性肿瘤##失眠##焦虑障碍##癌
喉癌累及下咽	喉恶性肿瘤##癌##咽恶性肿瘤
双耳感音神经聋老年性聋	老年性聋##双侧感音神经性聋
真菌性菌尿治疗后	泌尿系感染##真菌感染
药疹血管性水肿型	药物性皮炎[药疹]
右乳纤维上皮性肿瘤	纤维上皮瘤
鼻咽顶壁、顶后壁及右侧壁未分化型非角化性癌肺转移	鼻咽顶恶性肿瘤##鼻咽侧壁恶性肿瘤##未分化的癌##肺继发恶性肿瘤##转移性癌
小脑蚓部髓母细胞瘤综合治疗后	小脑恶性肿瘤##髓母细胞瘤
右眼goldenhar综合征	第一、二鳃弓综合征[Goldenhar综合征]
"上腹胀痛待查，左肺上叶磨玻璃结节,结肠多发息肉 肠镜检查,胃镜检查,预防出血,结肠镜下息肉电切，预防出血,甲状腺癌,胃溃疡"	上腹痛##腹胀##肺占位性病变##结肠息肉##甲状腺恶性肿瘤##胃溃疡##癌
继发性不孕子宫输卵管不通	继发不孕
双肾多发小囊肿后天性	后天性肾囊肿
乳腺癌术后骨转移严重骨质疏松	乳腺术后##乳腺恶性肿瘤##癌##骨继发恶性肿瘤##重度骨质疏松##转移性癌
1十二指肠球部杜氏病	十二指肠球部溃疡##胃粘膜下恒径动脉破裂出血
鼻咽低分化鳞癌治疗后的随诊检查	鼻咽恶性肿瘤##鳞状细胞癌
右侧鼻腔新生物	鼻腔息肉
鼻骨多发骨折	鼻骨骨折
核上性麻痹	进行性核上性眼肌麻痹[斯蒂尔-里查森-奥尔谢夫斯基]
食管中-高分化鳞状细胞癌	食管中三分之一的恶性肿瘤##鳞状细胞癌
"上呼吸道感染，胃肠炎,心累待查?"	上呼吸道感染##胃肠炎
胃窦管状腺瘤伴轻-中度不典型增生Hp-	胃良性肿瘤##管状腺瘤##胃粘膜不典型增生
双膝软骨退变	双侧膝关节骨性关节病
胸中段食管鳞癌化疗后	食管胸中段恶性肿瘤##鳞状细胞癌##化学治疗
颅内病变所致的偏身无力萎缩	偏侧肢体无力##肌肉萎缩
左胫骨近端骨质改变左膝退变	单侧膝关节骨性关节病
霍奇金淋巴瘤放疗后	霍奇金淋巴瘤##恶性肿瘤放疗
卵巢高级别浆液性乳头状癌IIIc期术后	卵巢恶性肿瘤##浆液性癌##卵巢术后
"腰痛,肝脾不调"	腰痛
右肺肺纤维化纤维灶	肺诊断性影像异常##肺纤维化
"直肠癌术后（Kras 野生型）,肝转移瘤术后复"	直肠术后##直肠恶性肿瘤##肝继发恶性肿瘤##转移性癌##肝术后
新生儿缺陷缺氧性脑病后遗症	新生儿缺氧缺血性脑病##缺血缺氧性脑病后遗症
脾肿大原因待查血液系统疾病	脾大##血液和造血器官未特指的疾病
颅内脱髓鞘病变待诊	脱髓鞘病
鼻咽癌根治性放射治疗	鼻咽恶性肿瘤##癌##恶性肿瘤放疗
泌尿系异常	泌尿系统未特指的疾患
脾肿大	脾大
肺癌化疗贫血	肺恶性肿瘤##化学治疗##贫血##癌
系统性红斑狼疮关节病变	系统性红斑狼疮
周围神经病变--酒精性周围神经病变可能	多发性神经病[多发性神经炎/周围神经炎]##酒精中毒性周围神经病
热衰竭多脏器功能障碍	多脏器功能障碍综合征[MODS]##中暑
左足副舟骨左膝退变	先天性足副舟骨##单侧膝关节骨性关节病
宫壁组织显变性并见少量胎盘组织粘连	胎盘粘连不伴出血
周围神经病慢性格林巴雷急性发作	吉兰-巴雷综合征##多发性神经病[多发性神经炎/周围神经炎]
卵巢高级别浆液性腺癌III期	卵巢恶性肿瘤##浆液性腺癌
"右肾癌术后，免疫力降低,左肾多发囊肿，右肾囊肿"	肾恶性肿瘤##肾囊肿##癌
双侧额顶叶白质缺血脱髓鞘改变	脱髓鞘性白质脑病##脑血管供血不足
右胫腓骨远端粉碎性开放性骨折伴感染	胫骨远端骨折伴腓骨骨折##感染
左下肢浮肿乏力	下肢水肿##乏力
大疱性表皮松解萎缩坏死型药疹	莱尔综合征[lyell综合征]
双乳腺增生并导管扩张	乳腺增生##乳腺导管扩张症
右眼睑皮肤挫伤	眼睑挫伤
双侧输尿管肾盂肾盏积液	肾积水##输尿管积水
非霍奇金弥漫大B细胞淋巴瘤IIIA	非霍奇金淋巴瘤##弥漫大B细胞淋巴瘤
左踝副舟骨源性平足	先天性足副舟骨##扁平足
先天性右室双出口	右心室双出口
直肠中分化腺癌根治术后 IIIc期 pT4aN2aM0	直肠术后##直肠恶性肿瘤##腺癌##淋巴结继发恶性肿瘤
小细胞鳞状细胞癌	小细胞-鳞状细胞癌
新生儿RH溶血	新生儿Rh血型不合溶血病
回盲肠管状腺瘤	回肠良性肿瘤##盲肠良性肿瘤##管状腺瘤
"直肠癌 盆腔淋巴结转移 术前放化疗,恶心 呕吐"	直肠恶性肿瘤##盆腔淋巴结继发恶性肿瘤##恶性肿瘤术前放疗##恶性肿瘤术前化疗##恶心和呕吐##癌
头昏沉原因癔症样发作	头晕##癔症样发作
晚期胃癌，长期不能进食	胃恶性肿瘤##进食障碍##癌
眼睑皮肤外伤	眼睑和眼周区其他浅表损伤
脓毒血症人型葡萄球菌人型亚种	未特指的葡萄球菌性脓毒病
骨髓增殖性肿瘤治疗后	骨髓增生异常性/骨髓增殖性肿瘤(不能分型)
皮肤真皮及皮下组织癌转移	皮肤继发恶性肿瘤##转移性癌
躯体化障碍重度焦虑抑郁	焦虑状态##抑郁状态
双肺支气管扩张合并感染	支气管扩张症合并感染
痔疮术后出血	痔##出血
脑血管硬化症	脑血管硬化
右手拇指挤压离断伤	拇指挤压伤##手指开放性损伤
胃癌伴幽门梗阻	胃恶性肿瘤##幽门梗阻##癌
腰椎间隙感染	感染
侧脑室异常信号影	"颅骨和头诊断性影像检查的异常所见,不可归类在他处者"
原发性肝癌（右）肝动脉插管化疗栓塞术后	肝恶性肿瘤##癌
单纯疱疹病毒性脑膜脑炎	单纯疱疹病毒性脑炎
肺动脉收缩压中度增高心功能Ⅲ-Ⅳ级	中度肺动脉高压##心功能III级(NYHA分级)##心功能IV级(NYHA分级)
"右肺下叶低分化癌骨转移 淋巴结转移 IV期,双肺多发小结节性质待查"	右肺下叶恶性肿瘤##骨继发恶性肿瘤##淋巴结继发恶性肿瘤##肺占位性病变##癌##转移性癌
原发性右肝癌	肝恶性肿瘤##癌
原发性甲状腺机能亢进症(复发)	原发性甲状腺功能亢进
"直肠癌,化疗,贫血,肝损伤"	直肠恶性肿瘤##化学治疗##贫血##肝损伤##癌
右眼睑感染	眼睑未特指的炎症
卵巢中低分化腺癌	卵巢恶性肿瘤##腺癌
口腔软组织挫伤	口腔和咽喉部损伤
左手指动脉畸形	周围动脉畸形
肩胛痛;颈椎间盘突出	背痛##颈椎间盘突出
右侧下牙龈癌	牙龈恶性肿瘤##癌
右腕部正中神经部分断裂	腕部正中神经损伤##正中神经断裂
直肠粘膜低级别管状腺瘤	直肠良性肿瘤##管状腺瘤
右眼球贯通伤	眼球贯通伤不伴有异物
手术后状态(宫内节育器置入)	具有子宫内避孕装置##其他特指的手术后状态
原发性皮肤钙质沉着	钙质沉着症
双侧骨性关节炎	骨关节病
右肺中叶结核性肉芽肿性改变	肺肉芽肿##肺结核
双卵巢低中分化浆液性乳头状腺癌	卵巢恶性肿瘤##乳头状浆液性腺癌
"右頬部鳞癌放疗,慢性牙周炎,下肢软组织恶性肿瘤,慢性牙周炎,残根,深龋,牙列缺损,开口受限"	颊部恶性肿瘤##鳞状细胞癌##恶性肿瘤放疗##慢性牙周炎##下肢软组织恶性肿瘤##慢性牙周炎##残留牙根##龋病##牙列缺损
因子Ⅷ缺乏伴有血管缺陷	凝血因子Ⅶ缺乏
左耳听阈轻度增高	听力减退
子宫肌间型平滑肌瘤	子宫平滑肌瘤##子宫平滑肌瘤
冠心病\支架术后\心绞痛	冠状动脉粥样硬化性心脏病##冠状动脉支架植入术后状态##心绞痛
个矮	身材矮小症
心湿性心脏病心功能１级	风湿性心脏病##心功能I级(NYHA分级)
早泄腰痛及右睾丸	早泄##腰痛
右腰背部肉芽肿性炎	肉芽肿
后躯干药物腐蚀后皮肤破损	腐蚀伤##皮肤缺损
左肺非小细胞肺癌Ⅳb期 cT4 N2 M1c 化疗	左肺恶性肿瘤##非小细胞癌##化学治疗##淋巴结继发恶性肿瘤
1妊娠晚期胎盘2胎膜脐带大致正常	妊娠状态
内风湿周围神经病变	多发性神经病[多发性神经炎/周围神经炎]
右膝髌骨骨梗死左肩峰下撞击征	骨坏死##肩撞击综合征
盆腔低分化神经母细胞瘤高危ufh型3期术前化疗5次术后化疗	盆腔恶性肿瘤##神经母细胞瘤##恶性肿瘤术前化疗##恶性肿瘤术后化疗
卵圆孔未闭或小房间缺损	卵圆孔未闭##房间隔缺损
双侧眉弓软组织挫裂伤	眉弓挫伤##眉弓裂伤
慢性移植物抗宿主反应病皮肤口腔指甲	慢性移植物抗宿主病
右下肢静脉曲张并血栓形成	下肢静脉曲张##下肢静脉血栓形成
左前降支肌桥轻度	冠状动脉肌桥
孕38+1周羊水偏少	孕38周##羊水过少
颈椎骨折术后	颈椎骨折##骨折术后
左口角粘膜包块	口腔肿物
眼外肌不全麻痹右外直肌右下直肌	眼下直肌麻痹
肿瘤骨转移胃炎	骨继发恶性肿瘤##转移性肿瘤##胃炎
直肠下段类癌	类癌瘤
右腘动脉支架置入术	周围血管支架植入术后状态
肾病(轻链沉积)	轻链肾病
女性乳腺癌	乳腺恶性肿瘤##癌
甲状腺压迫综合症	颈交感神经麻痹[霍纳综合征]
乙状结肠癌肝多发转移原发灶切除术后（T4N1M1 IV期）	结肠术后##乙状结肠恶性肿瘤##肝继发恶性肿瘤##癌##转移性癌
鼻部纤维丘疹病	丘疹
右髂总静脉血栓形成	髂静脉血栓形成
右足舟骨及骰骨撕脱性骨折	足舟骨骨折##骰骨骨折
肾小球系膜细胞及基质轻度增生	系膜增殖性肾小球肾炎
右眼睑色素斑	色素沉着未特指的疾患
支气管炎肺气肿	支气管炎##肺气肿
非化脓性静脉窦血栓形成	非化脓性颅内静脉窦血栓形成
B细胞肿瘤	B细胞淋巴瘤##淋巴瘤
双侧肾输尿管切除术后	肾术后##输尿管术后
妊娠出血	妊娠状态##出血
左手掌面皮肤软组织大部缺失神经血管缺失	皮肤缺损##血管断裂##神经断裂
上肢动静脉瘘	动静脉瘘
骶骨外伤	骶骨骨折
左肺部块影待查：肺恶性肿瘤？肺炎？肺结核？	肺部阴影##左肺恶性肿瘤##肺炎##肺结核
十二指肠降部腺瘤	十二指肠良性肿瘤##腺瘤
重度骨质疏松症冠心病高血压结缔组织病	重度骨质疏松##冠状动脉粥样硬化性心脏病##高血压##结缔组织病
多指[趾]和并指[趾]畸形	多指[趾]和并指[趾]畸形
右侧DDHCroweIV型继发OA	先天性髋关节发育不良##髋骨关节病
胃食管连接处慢性炎	胃炎##食管炎
右侧胸水原因1肝源性2其他	胸腔积液
横结肠造痿术后	结肠造口状态
G2P2孕38+2周宫内妊娠顺娩LOA	头位顺产
下肢静脉瓣膜功能不全	下肢静脉功能不全
完全性肺静脉异位引流心上型伴梗阻	"完全性肺静脉异位引流,心上型"
复极延迟综合征	长QT综合征
右桡骨头骨裂无移位	桡骨头骨折
消化性溃疡伴出血和穿孔	消化性溃疡伴出血##消化性溃疡伴穿孔
前降支肌桥	冠状动脉肌桥
脾血管扩张充血符合淤血性脾肿大	脾大
冠状动脉粥样硬化(狭窄)	冠状动脉狭窄##冠状动脉粥样硬化
经尿道输尿管软镜激光碎石术	输尿管结石
右坐骨神经瘤	神经瘤##坐骨神经良性肿瘤
左盂肱关节破坏结核性类风湿性	类风湿性肩关节炎##肩关节结核
升结肠管状腺瘤	升结肠恶性肿瘤##管状腺瘤
左肺中分化腺癌(T4N3M1)IV期	左肺恶性肿瘤##腺癌##淋巴结继发恶性肿瘤
副脾符合副脾伴淤血性肿大	先天性副脾##脾大
"肾移植术后,肺部感染"	肾移植状态##肺部感染
"食管癌,化疗呕吐反流性食管病,低钾血症水肿,行动不便,白细胞低,咳嗽"	食管恶性肿瘤##化学治疗##呕吐##反流性食管炎##低钾血症##水肿##白细胞减少##咳嗽##癌
月经不调肝肾不足	月经紊乱
急性缺血性脑病	脑血管供血不足
纵隔支气管囊肿	纵隔囊肿##支气管囊肿
双眼上睑倒睫术后	倒睫##眼术后
双肺挫伤伴感染	肺挫伤##肺部感染
产伤性Ⅱ度会阴裂伤	分娩伴会阴裂伤II度
低钾；肾癌术后；前列腺癌；颌下感染	低钾血症##肾恶性肿瘤##肾术后##前列腺恶性肿瘤##颌下感染##癌
下肢挫伤上肢挫伤	"上肢损伤##下肢未特指的损伤,水平未特指"
脑静脉血栓形成	脑血栓形成##静脉血栓形成
急性发热性中性白细胞皮肤病	急性发热性嗜中性皮病
陈发性房颤，窦缓	阵发性心房颤动##窦性心动过缓
间断眼睑浮肿左下肢轻微浮肿	下肢水肿##眼睑水肿
胎膜及脐带未见明显异常胎盘绒毛多灶性梗死	胎盘梗死
右胸腔巨大占位并胸腔积液	胸腔积液##胸部占位
腰椎间盘突出症继发椎管狭窄	腰椎间盘突出##腰椎管狭窄
恶性肿瘤局部动脉灌注治疗	部位未特指的恶性肿瘤##恶性肿瘤灌注治疗
肺气肿并肺大疱形成	大疱性肺气肿
特指手术后状态(甲状腺癌术后、子宫肌瘤剜除术后、宫外孕术后)	其他特指的手术后状态##甲状腺恶性肿瘤##甲状腺术后##癌##子宫平滑肌瘤##子宫术后##异位妊娠
视神经发良不良	视神经发育不良
宫颈锥切术后	宫颈术后
右侧骶韧带妊娠	异位妊娠
面部粟粒疹尿布疹	尿布性皮炎##粟疹
电弧烧伤面部	面部烧伤##电流引起烧伤
双胎之一胎儿左心室内强光点	双胎妊娠
右乳浸润性导管癌ⅡB期(pT2N1M0)改良根治术	乳腺术后##乳腺恶性肿瘤##浸润性导管癌
身体体表40～49％烧伤	体表40-49%的烧伤
面肿湿阻血瘀月经不调淋漓	月经紊乱
去势抵抗前列腺癌	前列腺恶性肿瘤##癌
幼年性毛细血管瘤	幼年性血管瘤##毛细血管瘤
慢性粒-单核细胞白血病	慢性粒单核细胞白血病
乙型肝炎表面抗原携带者	乙型病毒性肝炎表面抗原携带者
双手麻木原因待查周围神经病变可能性大	多发性神经病[多发性神经炎/周围神经炎]
降结肠癌术后拟行第二次化疗	降结肠恶性肿瘤##癌##恶性肿瘤术后化疗
左眼角膜间质纤维化伴灶性浅表糜烂	角膜糜烂
腰椎间盘突出症高`血压	腰椎间盘突出##高血压
甲状腺良性疾病手术后	未特指的甲状腺疾患##甲状腺术后
左耳化脓性中耳炎	化脓性中耳炎
慢性非特异性溃疡性结肠炎	溃疡性结肠炎
股静脉小腿静脉疾患曲张	其他特指部位的静脉曲张
造瘘口旁皮肤红肿	人工造口状态
左腕三角软骨盘撕裂下尺桡不稳	腕部损伤##关节不稳定
右下唇鳞癌	下唇恶性肿瘤##鳞状细胞癌
急性肾炎综合症	急性肾炎综合征
双侧大隐静脉瓣膜功能不全	下肢静脉功能不全
颈髓髓内病变伴空洞形成	脊髓空洞症##脊髓病
左乳头溢液:导管内乳头状瘤	导管内乳头状瘤##乳腺良性肿瘤##乳头溢液
脑白质病 脑萎缩	脑萎缩##脑白质病
高血压伴心律失常	高血压##心律失常
左腿肿痛	下肢肿胀##下肢疼痛
胸腰椎椎间盘膨出	腰椎间盘移位##其他特指的椎间盘移位
脑静脉畸形	脑静脉畸形
左乳肿块性质待查:癌	乳房肿物##乳腺恶性肿瘤##癌
不育由于精子减少症	男性不育症##少精子症
胃窦溃疡型中低分化腺癌	胃窦恶性肿瘤##腺癌
脑内多发缺血性脱髓鞘灶幕上脑室增大	脱髓鞘病##脑室扩张
左耳外耳道疖肿耳廓疖肿	外耳道疖##耳廓疖
外阴纤维上皮间质性息肉	外阴皮赘
毛细血管扩张光老化斑	毛细血管扩张症##日晒伤
左示指皮肤缺失甲床缺损骨外露	皮肤缺损
性交出血、盆腔炎	性交后出血##女性盆腔炎
腰5椎体病变伴双下肢不全瘫	不完全性瘫痪##截瘫[双下肢瘫痪]##腰椎病
不慎摔倒致左髋部着地受伤	髋部损伤##摔伤
大肠溃疡型中分化腺癌	腺癌
主动脉瓣二尖瓣慢性病变	未特指的二尖瓣疾病##未特指的主动脉瓣疾患
骨髓增生异常骨髓增殖性肿瘤	骨髓增生异常性/骨髓增殖性肿瘤(不能分型)
不典型甲状旁腺腺瘤	甲状旁腺良性肿瘤##腺瘤
糖尿病合并症高血压病上感重度骨关节病	糖尿病性高血压##上呼吸道感染##重度骨关节病
右颈神经鞘瘤	颈部周围神经和自主神经良性肿瘤##神经鞘瘤
药疹Stevens-Johnson综合征	药物性皮炎[药疹]##史蒂文斯-约翰逊综合征
停经312周10单活胎胎儿脊髓低位	妊娠状态##先天性脊髓低位
反复睡眠差鼻塞缺钙	钙代谢紊乱
胃体印戒细胞癌	胃体恶性肿瘤##印戒细胞癌
鳃裂畸形	先天性鳃裂畸形
尺骨茎突炎	骨突炎
右足跟黑色素瘤 双肺转移	足恶性肿瘤##恶性黑色素瘤##肺继发恶性肿瘤##转移性恶性黑色素瘤
骶裂半大便失控	骶椎椎板裂##大便失禁
车祸伤，左胫骨下段骨折	胫骨远端骨折
颊部血管瘤	面部血管瘤
左腕舟骨月骨三角骨缺血坏死	月骨缺血性坏死##骨缺血性坏死
产后胎盘残留胎盘置入	胎盘部分残留不伴出血##胎盘植入不伴出血
活检病理横结肠管状腺瘤I级	管状腺瘤##横结肠良性肿瘤
肺非典型类癌	非典型类癌性瘤##肺恶性肿瘤
右侧舌根部鳞状细胞癌伴颈部淋巴结转移术后（T2N1M0）	舌恶性肿瘤##鳞状细胞癌##颈部淋巴结继发恶性肿瘤
继发不孕双侧输卵管部分切除后	继发不孕##输卵管术后
左股部病变并膝关节活动受限	骨病变
3第1次腹腔化疗后	化学治疗
（左肾）符合重复肾	重复肾
不慎被玻璃管割伤右手食指	手指开放性损伤##玻璃割伤
急性淋巴细胞白血液病	急性淋巴细胞白血病
先天性肾血管畸形	肾血管畸形
右侧面部咀嚼瞬目综合症	下颌瞬目综合征[MarcusGunn综合征]
急性T髓混合细胞性白血病	T淋巴细胞和髓系混合表型急性白血病
支气管哮喘；免疫紊乱;	支气管哮喘
左踝关节及距下关节骨质破坏伴局部缺失	骨质破坏
原发退变性胸腰椎侧凸	脊柱侧弯##脊椎退行性病变
左下肢浮肿待查淋巴管回流障碍可能性大	淋巴回流障碍##下肢水肿
食管髓质型低分化鳞状细胞癌	食管恶性肿瘤##鳞状细胞癌
黄斑裂孔特发性	黄斑裂孔
意义未明单克隆免疫球蛋白血症	意义未明的单克隆丙种球蛋白病
右肺淋巴结增生性病变	淋巴组织增生
右环指近节指骨近端内生软骨瘤	指骨近节骨折
其他特指皮肤棘层松解性疾患	其他特指的皮肤棘层松解性疾患
头面部外伤-头外伤后反应左第八肋骨骨折	头部损伤##面部损伤##肋骨骨折
语言功能障碍	言语和语言发育障碍
凝血功能障碍维生素K依赖性	凝血功能障碍##维生素K缺乏
心功能4级(KILLIP分级)	KillipIV级
右侧颈内动脉C1段动脉瘤	颈内动脉瘤
左乳腺肿物伴感染	乳房肿物##感染
结核性软组织炎	结核感染
左侧胸部贯通枪伤	胸部开放性损伤##枪击伤
急性喉炎并喉梗阻I度	急性喉炎##喉梗阻
哮喘(Athmas)	支气管哮喘
胃浸润型印戒细胞癌	胃恶性肿瘤##印戒细胞癌
左乳晕溃疡性质待查考虑Paget‘s病	乳房佩吉特病##乳晕恶性肿瘤
腰椎退行性变并椎间盘突出	腰椎退行性病变##腰椎间盘突出
降结肠低级别管状腺瘤	降结肠良性肿瘤##管状腺瘤
脑动脉供血不足贫血肝肾不足气阴不足	脑动脉供血不足##贫血
肛门扩约肌功能稍弱	肛门括约肌松弛
额部软组织挫擦伤	头部损伤
右手舟骨月骨脱位伴月骨坏死	腕舟骨脱位##月骨缺血性坏死
关节固定术后状态	关节固定术状态
"左眼顿挫伤,眼睑皮下淤血"	眼和眶其他损伤##眼睑皮下淤血
胸椎管内神经鞘瘤	神经鞘瘤##椎管内良性肿瘤
"胰头部占位,肝内多发可疑转移"	胰腺占位性病变##肝继发恶性肿瘤##转移性肿瘤
色素牙	牙齿变色
G4P2孕39周已产LOA	正常分娩
胸腰椎多发陈旧骨折	胸椎多发性骨折##陈旧性胸椎骨折##腰椎多发性骨折##陈旧性腰椎骨折
子宫肌肿瘤	子宫平滑肌瘤##子宫平滑肌瘤
"胃癌,腹腔腹膜后淋巴结M,疼痛,呕吐,便秘"	胃恶性肿瘤##癌##腹腔淋巴结继发恶性肿瘤##腹膜后淋巴结继发恶性肿瘤##疼痛##呕吐##便秘
急性中耳炎;鼻中隔偏曲;慢性鼻咽炎;鼻炎;外耳道疖;变应性支气管炎	急性中耳炎##鼻中隔偏曲##慢性鼻咽炎##鼻炎##外耳道疖##支气管炎
妊娠合并胎儿畸形	胎儿畸形
B淋巴细胞淋巴组织增生性病	淋巴细胞增殖性疾病##淋巴组织增生
右肘游离体创伤性OA	肘关节内游离体##肘骨关节病
乳腺癌术后左颈部淋巴结肿大	乳腺术后##乳腺恶性肿瘤##癌##颈淋巴结肿大
右手掌疤痕挛缩伴食指屈指肌腱粘连	瘢痕挛缩##手指屈肌肌腱粘连
胃底中分化腺癌	胃底恶性肿瘤##腺癌
左膝腘窝软组织劳损	膝的其他和未特指部位的扭伤和劳损
直肠隆起型中分化腺癌	直肠恶性肿瘤##腺癌
吐血查因右上纵膈气体	咯血
"右侧乳腺癌，晚期,高血压病"	乳腺恶性肿瘤##癌##高血压
镜面右位心	镜面右位心
左肺转移	肺继发恶性肿瘤##转移性肿瘤
卵巢继发癌	卵巢继发恶性肿瘤##继发性癌
神经症右下肺间质性损害	神经症性障碍##间质性肺病
进行性掌指角皮病	角化病
色素沉着原因待查扁平苔藓	色素沉着未特指的疾患##扁平苔癣
阴囊阴茎派杰病	乳房以外的佩吉特病##阴囊恶性肿瘤##阴茎恶性肿瘤
1左距腓前韧带撕裂2左跟腓韧带撕裂	踝距腓前韧带断裂##跟腓韧带断裂
升结肠中分化腺癌pT1N0M0	升结肠恶性肿瘤##腺癌
右肺上叶轻度支气管扩张	支气管扩张症
十二指肠壶腹癌IV期化疗	法特壶腹恶性肿瘤##癌##化学治疗
L1腰椎压缩性骨折	腰椎压缩性骨折
内侧指神经血管断裂	血管断裂##神经断裂
鼻部癌	鼻部恶性肿瘤##癌
右侧卵巢囊肿术后	卵巢囊肿##卵巢术后
右手桡骨伸直性骨折	桡骨骨折
右枕部异常信号影	"颅骨和头诊断性影像检查的异常所见,不可归类在他处者"
右卵巢成熟性囊性畸胎瘤蒂扭转	成熟型囊性畸胎瘤##卵巢良性肿瘤
混合性肝细胞癌和胆管癌	肝细胞癌##胆管癌
左心收缩功能减弱	心功能不全
右侧头面部软组织挫伤	头皮挫伤
十二指肠至空肠粘膜慢性炎粘膜肌层内?	慢性肠炎
停经276周B超提示胎儿右侧胸腔低回声	妊娠状态
右前臂背伸肌腱陈旧性继裂	上肢肌肉肌腱断裂
左踝、颈外伤	颈部损伤##踝部损伤
上呼吸道感染、呕吐（胃炎）	上呼吸道感染##呕吐##胃炎
冰余胆总管新生物符合管状腺瘤	胆管息肉##胆管良性肿瘤##管状腺瘤
大便习惯性质改变待查肠镜检查	大便习惯改变
"胃角Ca,胃镜检查,预防出血"	胃恶性肿瘤##癌
胃窦增生行息肉横结肠管状腺瘤低级别	管状腺瘤##胃息肉##横结肠良性肿瘤
左眼突眼伴充血查因海绵窦漏	突眼性情况##海绵窦动静脉瘘
脆骨综合征	成骨不全[脆骨病]
右外耳道乳头状瘤	外耳道良性肿瘤##乳头状瘤
下唇色素斑	色素斑
中分化腺癌	腺癌
左肾缺失	先天性肾缺如
耻骨上经膀胱前列腺切除术	前列腺术后
腰45骶1椎间盘膨出椎体高信号	腰椎间盘突出##其他特指的椎间盘移位
辐射损伤	"暴露于未特指类型的辐射下造成的损伤,在未特指场所"
外阴鳞癌	外阴恶性肿瘤##鳞状细胞癌
左肘关节尺侧副韧带肱骨髁止点撕脱性骨折	肱骨骨折
室管膜瘤术后	室管膜瘤##脑术后
重度慢性牙周炎	慢性牙周炎
双小腿皮肤皮下结节性病变	下肢占位
左侧面舌部麻木查因脱髓鞘性	脱髓鞘病
甲状腺轻度非典型病变	未特指的甲状腺疾患
右侧臀部胚胎性横纹肌肉瘤术后复发	臀部恶性肿瘤##胚胎型横纹肌肉瘤##恶性肿瘤复发
肝左内叶胆囊窝旁低密度影考虑小囊肿	肝囊肿
食管低分化癌	食管恶性肿瘤##癌
产后出血术中	产后即时出血
右乳良性分叶状肿瘤	乳腺良性肿瘤##良性叶状瘤
关节周围软组织挫伤	"躯干未特指的损伤,水平未特指"
急性移植抗宿主病皮肤胃肠道	急性移植物抗宿主病
左肺腺癌根治术后伴双肺转移	肺术后##左肺恶性肿瘤##肺继发恶性肿瘤##腺癌##转移性腺癌
胆囊癌，高血压	胆囊恶性肿瘤##癌##高血压
颈腰部软组织劳损	肩颈部劳损##腰部劳损
盆腔腹膜多发低回声结节	腹膜占位##盆腔占位
"上呼吸道感染慢性咽炎感冒,口腔黏膜溃疡,胃镜检查,病毒性感冒"	上呼吸道感染##慢性咽炎##感冒##口腔黏膜溃疡##病毒性感冒
6指畸形	多指
AECOPD肺心衰右侧包裹性胸水	慢性阻塞性肺疾病急性加重##包裹性胸腔积液##心力衰竭
多发椎体骨质破坏并不全瘫	不完全性瘫痪##骨质破坏
上颌前牙釉质发育不全	釉质发育不全
多发性脑梗塞；脑缺血脱髓鞘；记忆力减退	多发性脑梗死##脑血管供血不足##脱髓鞘性脑病
滤泡性淋巴瘤伴弥漫性大B细胞淋巴瘤转化	滤泡淋巴瘤##弥漫大B细胞淋巴瘤
硬化萎缩性苔藓左腋部复诊	硬化性萎缩性苔癣[白点病]
自身免疫性疾病倾向	自身免疫病
左颊部及右舌部扁平苔藓	口腔扁平苔癣##舌扁平苔癣
造瘘口部分肠管坏死伴坍陷	肠坏死##人工造口状态
副乳头	副乳头
慢性肾功能衰竭;急性肾损害;防冻液中毒，中毒性脑病	慢性肾衰竭##急性肾功能不全##防冻液中毒##中毒性脑病
子宫不全纵膈	子宫不全纵隔
"冠心病,心绞痛型+缺血性心肌病"	心绞痛##缺血性心肌病##冠状动脉粥样硬化性心脏病
特指手术后状态(右髋骨、手掌骨折术后)	其他特指的手术后状态##骨盆骨折##掌骨骨折##骨折术后
直肠管状腺癌（T2N0M0)I期	直肠恶性肿瘤##管状腺癌
肝门部胆管细胞癌	肝恶性肿瘤##肝胆管细胞癌
多发性大肠息肉	大肠息肉
双卵巢子宫内膜样囊肿	卵巢囊肿
头痛.头晕.高血压	头痛##头晕##高血压
右睾丸精原细胞瘤T1N0M0	精原细胞瘤##睾丸恶性肿瘤
右下肢神经病变	多发性神经病[多发性神经炎/周围神经炎]
车祸伤:左踝部皮肤软组织撕脱伤伴骨外露	下肢撕脱伤
左拇指多指畸形	未特指的多指[趾]畸形
舌系带矫正术后	舌术后
贲门早CA 胃息肉	贲门恶性肿瘤##癌##胃息肉
早孕合泌感	妊娠状态##泌尿系感染
妊娠合并子宫肌瘤红色变性	妊娠合并子宫肌瘤
右侧甲状腺滤泡型腺瘤囊性变	甲状腺良性肿瘤##滤泡性腺瘤
腰椎管占位	椎管内占位性病变
新生儿血型不合溶血症	新生儿溶血
左上颌窦真菌送检为真菌团倾向为曲霉菌	上颌窦曲霉菌病
右食指无力待查	肌无力
宫颈局灶复鳞上皮呈CINII级并累及腺体	宫颈上皮瘤样病变[CIN]II级
右锁骨上淋巴结继发恶性肿瘤放化疗后	锁骨上淋巴结继发恶性肿瘤##恶性肿瘤放疗##化学治疗
急性粒细胞白血病MCR2	急性粒细胞性白血病##急性粒细胞白血病
乙脑后遗症右上强直瘫	流行性乙型脑炎后遗症
左侧上颌窦炎性假瘤	上颌窦肿物##炎性假瘤
后枕部头皮压疮并头皮坏死	压疮
"高血压病,糖尿病,冠心病，白内障"	高血压##糖尿病##冠状动脉粥样硬化性心脏病##白内障
回盲部黄色肉芽肿性炎	黄肉芽肿
颅内多发性结核瘤	结核感染
"结肠癌术后肝转移 手术及RFA治疗后,贫血 白"	结肠术后##结肠恶性肿瘤##癌##肝继发恶性肿瘤##转移性癌##贫血##恶性肿瘤射频治疗
右上腭鳞癌	腭恶性肿瘤##鳞状细胞癌
F2脐动脉舒张期血流缺失	脐血流异常
停经281周B超提示胎儿肠管明显扩张	妊娠状态
36颊侧移位II度松动	牙齿移位
左侧口底粘膜下血肿机化	血肿机化
宫颈高危HPV53高PRL血症	高泌乳素血症##人乳头瘤病毒感染
"胃溃疡、反酸,甲状腺癌术后"	胃溃疡##反酸##甲状腺术后##甲状腺恶性肿瘤##癌
美尼尔氏综合症膜迷路积水	膜迷路积水##梅尼埃病
低钾低钠血症	低钠血症##低钾血症
急性脑梗死右侧颞枕叶出血性梗死	脑梗死##多发性脑梗死##出血性脑梗死
胃窦部异位胰腺伴部分导管囊状扩张	胃内异位胰腺
右侧大量胸腔积液	胸腔积液
卵巢低级别浆液性腺癌	卵巢恶性肿瘤##浆液性腺癌
右眼玻璃体术后，硅油眼	眼术后
肺部曲毒菌病	肺曲霉菌病
右侧先髋半脱位伴OA	单侧膝关节骨性关节病##先天性单侧髋关节半脱位
脑梗死后遗症-偏瘫肢体功能康复	脑梗死后遗症##偏瘫
右足化脓性病灶切开延迟愈合	开放性损伤延期愈合##足感染
移植肾静脉狭窄	肾移植状态
复发滤泡淋巴瘤	滤泡淋巴瘤##恶性肿瘤复发
腰椎压缩性骨折L3	腰椎压缩性骨折##腰椎骨折L3
右耳极重度感音神经性听力丧失	感音神经性聋
糖尿病性胃肠植物神经病变	糖尿病性自主神经病
阴道不全纵膈	阴道纵隔
高血酯病4高血酯病	高脂血症
胸背部肌筋膜劳损	背部劳损
1宫颈鳞状细胞CAⅡb期 2高血压病	子宫颈恶性肿瘤##鳞状细胞癌##高血压
额部创伤后不愈	头部损伤##开放性损伤愈合不良
肺曲霉病(?)	肺曲霉菌病
眼睑组织炎	眼睑未特指的炎症
全身骨关节先天发育不良	骨骼发育不良
右腕部为变性坏死组织及纤维脂肪组织	脂肪坏死
甲状腺低分化鳞癌伴肺、颈淋巴结转移	甲状腺恶性肿瘤##鳞状细胞癌##颈部淋巴结继发恶性肿瘤
肝内及腹腔转移瘤	肝继发恶性肿瘤##腹腔继发恶性肿瘤##转移性肿瘤
G1P1孕41周已产LO	正常分娩
淋巴瘤白血病B细胞型	B细胞淋巴瘤
右髂动脉及股动脉支架置入术	血管支架植入术后状态
左下肢疼痛伴力弱	下肢疼痛
前列腺癌近距离治疗术后	前列腺恶性肿瘤##癌
舌静脉畸形	舌血管畸形
急性迟缓性麻痹	弛缓性瘫痪[周围性瘫痪]
热液烫伤12%浅二度8%深二度4%颈部背	躯干部烫伤
左股骨髁骨质改变左膝退变	单侧膝关节骨性关节病
耵聍堵塞	外耳道耵聍栓塞
右椎动脉管腔细小发育变异	椎动脉畸形
幼儿急疹[第六病]	幼儿急疹
乙状结肠癌术后辅助治疗，复查	结肠术后##乙状结肠恶性肿瘤##癌
右乳恶性肿瘤放疗	乳腺恶性肿瘤##恶性肿瘤放疗
神经痛胃肠性感冒	神经痛##胃肠型感冒
右肾实质萎缩并积水	肾积水##肾萎缩
腰1椎体爆裂骨折并脊髓损伤	腰椎骨折L1##腰部脊髓损伤
冠心病KippipⅡ级	冠状动脉粥样硬化性心脏病##KillipII级
放射性粘膜损伤	放射性损害
右小腿下段前内侧皮肤坏死缺失创面	下肢皮肤坏死##下肢皮肤缺损
自身免疫性疾病心脑受累	自身免疫病
前交通动脉瘤破裂	前交通动脉动脉瘤##大脑动脉瘤破裂
双眼老年性黄斑病变右眼陈旧性	老年性黄斑变性
甲状腺肿物切除	甲状腺肿物##甲状腺术后
卵圆孔未闭	卵圆孔未闭
左下肢萎缩待查反射性肌萎缩	下肢肌肉萎缩
唇部过敏	过敏反应##唇炎
右尺骨鹰嘴骨折不愈合	尺骨鹰嘴骨折
左眼视网膜剥脱失明	视网膜脱离##单眼盲
周围神经病关节变形有关	多发性神经病[多发性神经炎/周围神经炎]
鼾症伴低通气综合征	鼾症##睡眠低通气综合征
右髋关节骨折脱位	髋关节脱位##髋关节骨折
特发性点状白斑	特发性滴状色素减少症
胃窦病变伴上消化道大出血	胃和十二指肠未特指的疾病##上消化道出血
附件内膜异位症	输卵管子宫内膜异位症##卵巢子宫内膜异位症
先天性心脏病法洛四联症	先天性心脏病##法洛四联症
冠心病高血压脑梗塞结膜炎	冠状动脉粥样硬化性心脏病##高血压##脑梗死##结膜炎
乳腺浸润性导管癌Ⅱ-Ⅲ级	乳腺恶性肿瘤##浸润性导管癌
左侧膝关节放疗后	放射治疗
颈髓缺血变性C45C56水平	脊髓变性##脊髓缺血
宫颈肿瘤特殊筛选检查	宫颈肿瘤的特殊筛查
右甲状腺结节性甲状腺肿伴囊性变	结节性甲状腺肿##甲状腺囊肿
跖疣冷冻术后	掌跖疣
右腋下脂肪瘤	腋窝良性肿瘤##脂肪瘤
胎儿骨骼发育异常	骨骼发育不良
肺炎休克	肺炎##休克
小肠闭锁IIIa型并穿孔	先天性小肠闭锁##小肠穿孔
双肺下叶局限性气肿肺间质性改变同前	肺气肿
左大脑中动脉阻塞或变异	脑血管畸形
右肺下叶错构瘤	肺错构瘤
左下肺腺癌（T2N0MO Ib期）术后	肺术后##左肺下叶恶性肿瘤##腺癌
"食管胃交界癌术后,纳差"	食管胃连接部恶性肿瘤##癌##食欲不振
双侧卵巢中分化浆液-粘液混合性乳头状腺癌	卵巢恶性肿瘤##乳头状腺癌
脑梗死后出血	脑梗死##脑出血
宫腔异常回声待查节育环下移	避孕环移位
糖尿病（特病开药）	糖尿病
纵裂胆脂瘤	颅内胆脂瘤
双侧阴囊坏死左侧精索睾丸缺失	后天性阴囊缺失
右足针刺感腰椎间盘病变	椎间盘疾患
颈椎浆细胞骨髓瘤术后	颈椎恶性肿瘤##颈椎术后##浆细胞骨髓瘤
右颈部纤维脂肪病	颈部良性肿瘤##纤维脂肪瘤
左侧股骨外踝前壁内踝后壁撕脱性骨折	内踝骨折##外踝骨折##股骨骨折
胃痛肾虚	胃痛
粘液腺癌伴印戒细胞癌	粘液腺癌##印戒细胞癌
先天性软骨发育不良	软骨发育不全
食物蛋白性小肠结肠炎	蛋白质过敏病##过敏性肠炎
PANCREATICCANCER	胰腺恶性肿瘤##癌
肿瘤手术后	性质未特指的肿瘤
口服结核药物呕吐、食欲差	药物不良反应##呕吐##食欲不振
急性广泛前壁ST段抬高型心肌梗死	急性广泛前壁心肌梗死##急性ST段抬高型心肌梗死
右膝外侧半月Ⅲ裂撕轻度OA	单侧膝关节骨性关节病##膝外侧半月板撕裂
颈腰椎间盘多发性膨出	其他特指的椎间盘移位##腰椎间盘移位
食管低分化鳞状细胞癌	食管恶性肿瘤##鳞状细胞癌
面双上肢灼伤10%2度	面部开放性损伤##上肢开放性损伤
右腕蜂蜇伤	腕部损伤##蜂螫伤
室性早搏射频消融术后	室性期前收缩##心脏射频消融术后
口部外伤	口腔和咽喉部损伤
双侧颈总动脉分叉处混斑中度狭窄	颈总动脉狭窄##颈总动脉斑块
胸部枪伤	胸部开放性损伤##枪击伤
食管平滑肌瘤	平滑肌瘤##食管良性肿瘤
右足皮肤撕脱伴坏死	足部软组织撕脱伤##足坏死
心悸气短	心悸##气短
头颈肩胸损伤	肩部损伤##头部损伤##颈部损伤##胸部损伤
右股骨骨样骨瘤	骨样骨瘤##股骨良性肿瘤
运动神经功能损害	运动神经元病
不孕＼阴道霉菌	未特指的女性不孕症##真菌性阴道炎
右颈内静脉长期血透留置管破裂	血管透析导管的机械性并发症
胎盘残留伴部分胎盘植入	胎盘部分残留不伴出血##胎盘植入不伴出血
腺纤维瘤乳腺	腺纤维瘤##乳腺良性肿瘤
嗅神经母细胞瘤	嗅神经恶性肿瘤##嗅神经母细胞瘤
妊娠瘙痒闰（妊娠合并肝内胆汁淤积症）	妊娠期肝内胆汁淤积症##瘙痒症
部分导联T波改变8左房增大	心电图异常
传单反复扁桃体发炎	扁桃体炎##传染性单核细胞增多症[腺性热]
单绒毛膜双羊膜囊双胎妊娠;	双胎妊娠
炎症性关节炎	关节炎
胸膜转移癌	转移性癌##胸膜继发恶性肿瘤
右侧臂丛神经断裂	臂丛神经损伤##神经断裂
食管溃疡型中分化鳞形细胞癌	食管恶性肿瘤##鳞状细胞癌
右胫骨下段骨折24天	胫骨骨折
肘关节骨折术后	肘关节骨折##骨折术后
妊娠期B族链球菌感染	链球菌感染##妊娠状态
枕部蛰伤	昆虫咬伤
结肠平滑肌瘤	平滑肌瘤##结肠良性肿瘤
冠状动脉粥样硬化型心脏病心绞痛	冠状动脉粥样硬化性心脏病##心绞痛
子宫内膜中分化内膜样腺癌	子宫内膜恶性肿瘤##子宫内膜样腺癌
胎儿左右左心室内强光点	妊娠状态
肩关节滑膜炎	肩关节滑囊炎
胸膜继发癌	继发性癌##胸膜继发恶性肿瘤
前庭周围神经性病变	多发性神经病[多发性神经炎/周围神经炎]
剖宫产术后宫内早孕	剖宫产史的妊娠
右膝髂胫束断裂	"下肢未特指的损伤,水平未特指"
"尿毒症;肾性贫血;肾性高血压,透析中低血压"	尿毒症##肾性贫血##肾性高血压##O
高血压肾病便秘	高血压性肾病##便秘
"阴道恶性黑色素瘤扩切术后,局部复发术后"	恶性黑色素瘤##阴道恶性肿瘤##恶性肿瘤复发
距肛门55cm结肠管状腺瘤Ⅱ级	结肠良性肿瘤##管状腺瘤
右肺癌化疗后伽玛刀治疗后	右肺恶性肿瘤##化学治疗##癌##恶性肿瘤放疗
右腕劳损	累及上肢多个部位的脱位、扭伤和劳损
左侧枕部硬膜下积血积气	颅内积气[气颅症]##硬脑膜下积液
送检左肩冈上肌显坏死伴广泛钙盐沉积	钙质沉着症
胆囊息肉并胆囊炎	胆囊息肉##胆囊炎
叶酸缺乏症	叶酸缺乏
颈动脉狭窄(支架置入术后)	周围血管支架植入术后状态##颈动脉狭窄
冠心病急性心肌梗死肾功能不全	冠状动脉粥样硬化性心脏病##急性心肌梗死##肾功能不全
坠落伤右肱骨开放性骨折伴脱位	自高处坠落##上肢开放性骨折##肱骨骨折
克罗恩病（结肠型）	结肠克罗恩病
食管胃底静脉重度曲张	胃底静脉曲张##食管静脉曲张
糖尿病性周围神经病变;多发性神经炎	糖尿病性周围神经病##多发性神经病[多发性神经炎/周围神经炎]
右肺鳞状细胞癌	右肺恶性肿瘤##鳞状细胞癌
心律失常心房纤颤频发室性早搏	心律失常##心房颤动[心房纤颤]##频发性室性期前收缩
静脉化疗治疗	化学治疗
垂体腺瘤伴出血	垂体良性肿瘤##垂体腺瘤##肿瘤伴出血
"2型糖尿病,甲状腺腺瘤"	2型糖尿病##甲状腺良性肿瘤##腺瘤
右侧三叉神经鞘瘤	神经鞘瘤##三叉神经良性肿瘤
房间隔缺损介入封堵术后	心脏介入封堵术后状态
腰2椎体良性病变	腰椎病
多囊肾并出血	先天性多囊肾##肾出血
骨关节病双膝关节置换术后	双侧膝关节骨性关节病##人工关节术后
子宫出血，系统性红斑狼疮，中度贫血	异常子宫出血##系统性红斑狼疮##中度贫血
性交痛	性交疼痛
左室轻度扩大肺动脉增宽	左室扩大
右手中指鹅颈畸形	指天鹅颈状变形
左肾盂及上段输尿管扩张积水，左侧输尿管盆腔段狭窄	输尿管扩张##肾盂扩张##输尿管积水##输尿管狭窄
急性GVHD（肠道）可能性大	急性移植物抗宿主病
肝胆管细胞癌术后 梗阻性黄疸	胆道术后##肝胆管恶性肿瘤##肝胆管细胞癌##梗阻性黄疸
慢性风湿性心脏瓣膜疾病	瓣膜未特指的风湿性心内膜疾病
胃窦贲门增生性息肉	贲门息肉##胃息肉
高纤维蛋白原血症21低高密度脂蛋白血症	高纤维蛋白原血症##高密度脂蛋白缺乏
先天性颅裂枕部脑膜膨出	先天性脑膜膨出
慢性肾脏病急性加重透析状态	慢性肾病##肾脏透析状态
双下肢肌肉炎症	肌炎
呼吸道感染（过敏性咳嗽）	呼吸道感染##咳嗽
停经146周B超提示胎儿后颈部多枚囊性	妊娠状态
右腕豌豆骨撕脱性骨折并半脱位可疑	腕骨骨折##腕关节半脱位
慢性移植物抗宿主反应病肝脏口腔皮肤胃肠道	慢性移植物抗宿主病
右乳恶性肿瘤的支持治疗	乳腺恶性肿瘤##恶性肿瘤支持治疗
胃溃疡浸润型印戒细胞癌	胃恶性肿瘤##印戒细胞癌
"锁骨骨折(右侧,术后)"	锁骨骨折##骨折术后
低钾低钠待查过敏性性休克致	低钾血症##低钠血症##过敏性休克
右尺侧腕屈肌腱损伤	腕和手指屈肌腱损伤
右额叶病灶SRS放疗后	放射治疗
白血病骨髓移植术后	骨髓移植术后##白血病
(GMXS)慢性肾脏病，ckd5期	"慢性肾脏病,5期"
进食吞咽梗阻胃镜提示食管上段胃黏膜异位	吞咽障碍
右侧输尿管闭锁	先天性输尿管闭锁
克罗恩氏病贯通型轻度回结肠受累	回肠克罗恩病
功能性肠病肠易激综合症伴焦虑状态	肠易激综合征##焦虑状态
先天性腭裂伴有唇裂	先天性唇腭裂
右肺中叶肺癌	右肺中叶恶性肿瘤##癌
胎儿13-三体型综合征	13-三体综合征[Patau综合征]
(E11.900)2型糖尿病双眼糖尿病视网膜病变	2型糖尿病##2型糖尿病性视网膜病变
胃贲门中低分化腺癌IIIC期术后(pT4bN3aM0)	贲门术后##贲门恶性肿瘤##腺癌
腰椎间盘腰45椎腰5骶1椎突出继发椎	腰椎间盘突出
左侧额窦筛窦新生物	额窦息肉##筛窦息肉
外周T细胞淋巴肿瘤	外周T细胞淋巴瘤(非特指型)
右小腿外侧血管瘤	血管瘤
房室阻滞	房室传导阻滞
右髋股撞击症右盂唇撕裂	髋关节撞击综合征##髋部损伤
4慢性肺心病心功能3级	慢性肺源性心脏病##心功能III级(NYHA分级)
胃炎、胃息肉？	胃炎##胃息肉
(胎儿胼胝体缺如)	胼胝体发育不全
双侧枕叶散在小缺血梗塞陈旧性	陈旧性脑梗死
WHO肺高压心功能III级	肺动脉高压##心功能III级(NYHA分级)
右足跟部皮肤软组织脱套伤	足部套脱伤
右半结肠回盲部腺癌	回盲部恶性肿瘤##腺癌
产后乳汁自出	乳溢
右颞顶骨大面积粉凹陷性碎性骨折	颅骨骨折
弥漫性大细胞恶性淋巴瘤	弥漫大B细胞淋巴瘤##弥漫性大B细胞恶性淋巴瘤
面部癌	面部恶性肿瘤##癌
右肺周围型中分化腺癌	右肺恶性肿瘤##腺癌
头部疤痕性秃发	瘢痕性脱发[瘢痕性毛发缺失]
真菌性眼内炎	感染性眼内炎
阴茎根部Bowen氏病	鲍恩病##阴茎恶性肿瘤
关节肿大待查粘多糖病	关节肿胀##粘多糖贮积病
粒缺伴发热	粒细胞缺乏##发热
左房左室肥大左室舒张功能减退	心房肥大##心室肥大
C12病变并髓核压迫症	脊髓压迫症
右手掌疤痕组织挛缩伴肌腱粘连	瘢痕挛缩##瘢痕性肌腱粘连
醛固酮过多症	醛固酮增多症
侵及子宫后壁及双侧肛提肌	子宫继发恶性肿瘤
乏力，纳差，恶心，胸闷，心梗可能	乏力##食欲不振##恶心##胸闷##O
原发性皮质增多症Cushing病可能性大	皮质醇增多症[库欣综合征]
新生儿反应弱肌张力弱原因待查	新生儿未特指的肌张力疾患
右耳中度混合性聋左耳高频中度感音神经性聋	单侧混合性聋##单侧感音神经性聋
胆道取石术后	胆石症##胆道术后
发热肺部感染头晕脑出血后遗症	发热##肺部感染##头晕##脑出血后遗症
齿状突骨不连伴不全瘫	骨折不连接[假关节]##不完全性瘫痪
左眼黄斑劈裂伴视网膜浅脱离	视网膜劈裂症##视网膜脱离
肠系膜血管病-肠管坏死	肠坏死
颈56椎体左侧异常信号影	其他特指身体结构诊断性影像检查的异常所见
宫颈恶性肿瘤第一次化疗	子宫颈恶性肿瘤##化学治疗
自身免疫性疾病抗AMA-M2抗体阳性	自身免疫病
腹水症严重肝病	腹水##未特指的肝病
额面鼻外伤性疤痕左内眦韧带断裂移位	额部瘢痕##鼻部瘢痕##内眦移位
右膝髌上髌内侧滑膜皱襞综合征	膝关节滑膜皱襞综合征
"小细胞肺癌晚期化疗,水肿利尿便秘食欲减退,肝功能损害肺部感染,咳嗽行动不便疼痛"	肺恶性肿瘤##小细胞癌##化学治疗##水肿##便秘##食欲不振##肝功能异常##肺部感染##咳嗽##疼痛
心律失常高血压肿瘤冠心病脑血管病	心律失常##高血压##性质未特指的肿瘤##冠状动脉粥样硬化性心脏病##脑血管病
左上肢末梢神经、C6神经干电击伤	电击伤##上肢神经损伤##脊神经损伤
右侧胫骨上端骨折	胫骨上端骨折
血管斑痣	血管痣
"非霍奇金淋巴瘤，NK/T细胞淋巴瘤,侵及左鼻腔及副鼻窦,鼻咽镜检查活检，局麻预防出血,化疗后骨髓抑制，白细胞减低,关节痛"	非霍奇金淋巴瘤##O##鼻腔继发恶性肿瘤##鼻窦继发恶性肿瘤##化疗后骨髓抑制##白细胞减少##关节痛##转移性肿瘤
鼻咽占位待查	面部占位
左手小指甲床破裂指甲脱落	甲脱离
左小腿浅静脉血栓，软组织挫伤	下肢静脉血栓形成
食道高-中分化鳞癌粒子植入术后	食管术后##食管恶性肿瘤##鳞状细胞癌##恶性肿瘤放射性粒子置入治疗
右肺癌靶向治疗	右肺恶性肿瘤##恶性肿瘤靶向治疗##癌
胰腺肿瘤囊腺瘤	囊腺瘤##胰腺良性肿瘤
下肢胫前皮肤色素沉着	色素沉着未特指的疾患
男性功能减退	"未特指的性功能障碍,非由器质性障碍或疾病引起"
右上睑部分缺损伴闭合不全	眼睑闭合不全[兔眼]
胃窦隆起糜烂异位胰腺	胃内异位胰腺##糜烂性胃炎
胃窦隆起病变内镜粘膜下剥离术	胃术后##胃和十二指肠未特指的疾病
皮肤软组织挫伤	皮肤挫伤
支气管扩张症继发感染	支气管扩张症合并感染
左足第4趾部分坏死左足背皮肤缺损	足坏死##皮肤缺损
右眼人工晶体眼；右眼角膜白斑	人工晶体植入状态##角膜白斑
妊娠合并B族链球菌感染	链球菌感染##妊娠状态
肾脏发育异常	肾发育不全
车祸伤，左踝、足外伤	踝部损伤##足部损伤
突发特发性听觉减退左耳	突发性聋
CGD-MSD-BMT移植后4月	造血干细胞移植状态
化疗后肝功能下降	化疗药物反应##肝功能异常
1型糖尿病性植物神经病	1型糖尿病性自主神经病
右侧甲状腺结节性甲肿伴囊性变	结节性甲状腺肿##甲状腺囊肿
右腹股沟皮脂腺囊肿	皮脂腺囊肿
慢性心功能衰竭急性发作全心增大	慢性心力衰竭
糖尿病高血压并脑损害心脏损害	糖尿病##高血压##未特指的脑病##心脏损伤
1空蝶鞍2脑缺血脱髓鞘	脱髓鞘性脑病##脑血管供血不足
急性髓细胞白血病（CR）化疗	急性髓细胞白血病##化学治疗
营养性混合性贫血	营养性贫血##混合性贫血
左踝肿块	下肢肿物
右侧恶性胸水原发病灶待查	恶性胸腔积液
F1F2染色体多态改变	染色体病
G妊娠胎儿脐动脉SD升高已治愈	妊娠状态
b0干骺软骨发育不良症b	干骺端发育不良
肺囊性腺瘤样变	先天性腺瘤样肺囊肿
左颈部腮裂囊肿改变	鳃裂囊肿
口外伤	口腔和咽喉部损伤
妊1产0妊286周臀头位	妊娠状态
自身免疫疾病抗心磷之抗体增高	自身免疫病
左侧输尿管双J管拔除困难	取出输尿管支架管
双小腿肿痛	下肢肿胀##下肢疼痛
右腮腺肿块	唾液腺肿物
室性自身心律	室性逸搏性心律
肝左叶胆管上皮异型性增生	胆道不典型增生
宫颈癌术后化疗后复查	子宫颈恶性肿瘤##癌##恶性肿瘤化学治疗后的随诊检查##宫颈术后
妊娠合并肝内胆汁淤积征	妊娠期肝内胆汁淤积症
脑内多发缺血性脱髓改变	脱髓鞘性脑病##脑血管供血不足
肝功能心功能受损外伤性	肝功能异常
左心室高电压T波改变升主动脉增宽	心电图异常
感染(肿痛)	疼痛##感染
多器官功能损伤	多脏器功能障碍综合征[MODS]
口咽鳞状细胞癌	鳞状细胞癌##口咽恶性肿瘤
右侧输尿管上段结石伴轻度积水	输尿管结石##输尿管积水
双侧鼻腔鼻息肉	鼻腔息肉##鼻息肉
"左乳肿物,乳腺癌"	乳房肿物##乳腺恶性肿瘤##癌
下肢静脉炎和血栓性静脉炎	下肢血栓性静脉炎
左膝重度OA左膝胫骨骨缺损	单侧膝关节骨性关节病
"左卵巢高级别浆液性癌,甲状腺功能低下,失眠 关节疼痛,严重骨质疏松,失眠,便秘"	卵巢恶性肿瘤##浆液性癌##甲状腺功能减退##失眠##关节痛##重度骨质疏松##失眠##便秘
慢性全胃炎伴糜烂，糜烂性十二指肠炎	慢性胃炎##糜烂性胃炎##十二指肠炎
右侧小脑半球脑梗死	小脑梗死
水肿原因待查肾病综合征可能	水肿##肾病综合征
胸腺低分化鳞癌 cT2N2M1 IV期化疗	胸腺恶性肿瘤##鳞状细胞癌##化学治疗
青年上肢肌肉萎缩	上肢肌肉萎缩
短暂性缺血性脑病	脑血管供血不足
双下肢犬伤	下肢开放性损伤##被狗咬伤
不全行子宫纵隔	子宫纵隔
颈部淋巴瘤	颈淋巴结肿大
(左侧上颌窦）炎性息肉	上颌窦息肉##炎性息肉
高血压(眩晕-肝肾不足)	高血压##眩晕
右胸腹部外伤	胸部损伤##腹部损伤
卵巢类癌	类癌瘤
腔静脉癌栓	肿瘤栓子
右侧颞枕部急性硬膜下血肿	急性非创伤性硬脑膜下血肿
去分化型脂肪肉瘤	脂肪肉瘤
L12溶骨性破坏伴不全瘫	不完全性瘫痪##骨质破坏
退变的纤维软骨	软骨疾患
免疫风湿性疾病伴肺部侵润	风湿病
阴茎侧弯	阴茎屈曲畸形
放疗完成	放射治疗
左眼皮肤擦伤	眼睑和眼周区其他浅表损伤
咽部异物划伤	咽内异物##咽喉损伤
右侧小脑异常低密度影	"颅骨和头诊断性影像检查的异常所见,不可归类在他处者"
结肠多发低级别管状腺瘤	结肠良性肿瘤##管状腺瘤
骨髓增生异常综合征-原始细胞增多转化型	骨髓增生异常综合征
痉挛型脑性瘫	脑性瘫痪[脑瘫]
右足外伤/第2/3/4跖骨基底骨折	足部损伤##跖骨基底骨折
甲状腺包块	甲状腺肿物
mp感染	支原体性肺炎
停经361周B超提示胎儿卵圆孔增宽	妊娠状态
左足跟腱撕脱性骨折	跟骨骨折
右乳腺癌联合治疗后	乳腺恶性肿瘤##癌
特指手术后状态(双下肢大隐静脉曲张术后)	大隐静脉曲张##静脉曲张术后
双肺多发异常密度影复诊	肺部阴影
双侧输尿管结石并双肾积水	肾积水伴输尿管结石
双眼视神经发育迟缓	视神经发育不良
并周围神经病变并双眼代谢性眼病	多发性神经病[多发性神经炎/周围神经炎]
部分小肠缺血坏死回肠部分盲肠切除术	缺血性肠坏死##回肠术后##盲肠术后
血凝系统功能异常弥漫性血管内凝血可能	凝血功能异常##弥散性血管内凝血
尿色异常待查，呼吸道感染	呼吸道感染
全身多关节肿痛	关节肿胀##关节痛
纯红细胞再生障碍	纯红细胞再生障碍性贫血
卵巢透明细胞癌IC期	透明细胞癌##卵巢恶性肿瘤
便秘;结膜炎;慢性喘息性支气管炎;胃炎;冠心病心律失常型	便秘##结膜炎##O##胃炎##冠心病心律失常型
头面部多发骨折	颅骨和面骨多发性骨折
停经212周B超提示胎儿双侧肾脏回声增强	妊娠状态
双侧卵巢中低分化腺癌IIb2期	卵巢恶性肿瘤##腺癌
中重度主动脉反流	主动脉瓣关闭不全
"弥漫大B细胞淋巴瘤,消化系统念珠菌感染,病毒感染 免疫力下降,口腔黏膜炎溃疡 真菌感染,白细胞减低,放射性皮炎"	弥漫大B细胞淋巴瘤##O##感染##病毒感染##O##真菌感染##白细胞减少##放射性皮炎
双侧室管膜下囊肿	室管膜囊肿
右面部脉管畸形	头面血管畸形
胃癌术后骨转移术后	胃术后##胃恶性肿瘤##癌##骨继发恶性肿瘤##转移性癌
鞭炮炸伤1%II°右前臂	前臂开放性损伤##爆竹炸伤
异常子宫出节育环下移	避孕环移位
右侧乳腺错构瘤	乳房错构瘤
乳癌术后定期化疗，门诊开药	乳腺恶性肿瘤##恶性肿瘤术后化疗
腹腔热灌注化疗后	化学治疗
精神语言发育迟缓	言语和语言发育障碍
瘙痒症;盘状红斑狼疮;	瘙痒(症)##盘状狼疮
双手足发育不良	先天性手畸形##先天性足畸形
颌面部感染	感染
脑干出血后遗症期	脑出血后遗症
"小细胞肺癌限局期,化疗止吐，化疗预处理,低钾血症水肿,髋部周围神经和自主神经恶性肿瘤"	肺恶性肿瘤##小细胞癌##低钾血症##水肿##髋部周围神经和自主神经恶性肿瘤
供血不足，脑	脑血管供血不足
尿路结石术后	未特指的泌尿系结石
小脑扁桃体下疝畸形ARNOLD-CHIARI畸形	小脑扁桃体下疝畸形[Arnold-Chiari综合征]
肝硬化腹水，胸水	肝硬化##腹水##胸腔积液
考虑舌唇黏膜扁平苔藓	口腔扁平苔癣
左肘关节功能障碍左膝髌骨骨梗死	骨坏死
右耳轻度混合型聋左侧中度传导性聋	单侧混合性聋##单侧传导性聋
子宫颈上皮内病变CINIII级	子宫颈上皮内瘤变III级[CINIII级]
右侧鼻咽分化型非角化型鼻咽癌	鼻咽恶性肿瘤
心功能Ⅰ级KILLIP	KillipI级
口咽鳞癌化疗后	口咽恶性肿瘤##鳞状细胞癌##化学治疗
横行腹直肌肌皮瓣移植术后	皮瓣移植状态
放疗后继发不适	放射治
慢性心衰急性加重心功能II-III级C期	心功能Ⅱ--Ⅲ级(NYHA分级)##慢性心功能不全急性加重
猫抓伤病史	"被其他哺乳动物咬伤或抓伤,在未特指场所##损伤史"
食管胃结合部低分化腺癌，放疗后	食管胃连接部恶性肿瘤##腺癌##恶性肿瘤放疗
右乳浸润性导管癌中医治疗	乳腺恶性肿瘤##浸润性导管癌##恶性肿瘤中医治疗
慢性胆囊炎并胆囊多发结石	胆囊结石伴慢性胆囊炎
雷诺病	雷诺综合征
先天性肝内胆管扩张症	先天性胆管扩张
左肺癌	左肺恶性肿瘤##癌
子宫颈中分化鳞癌IIa1期	子宫颈恶性肿瘤##鳞状细胞癌
左膝重度外翻右膝重度内翻	膝外翻##膝内翻
"乙状结肠癌肝转移术后复发,肝转移,高血压病"	乙状结肠恶性肿瘤##癌##肝继发恶性肿瘤##转移性癌##恶性肿瘤复发##肝继发恶性肿瘤##转移性癌##高血压
高血压病(左室舒张功能减退)	高血压
陈旧性心梗后再梗左心室下壁心梗	急性再发心肌梗死
三支血管病变右冠闭塞性病变	冠状动脉闭塞
右眼继发性高眼压	高眼压症
G骨髓纤维化	原因不明性骨髓纤维化
回盲部Crohn病	大肠和小肠克罗恩病
甲亢性周期性麻痹	甲状腺功能亢进症合并周期性麻痹
高血压良性小动脉肾硬化症	小动脉性肾硬化##高血压
右足趾化脓性炎	趾头炎
直肠恶性肿瘤免疫治疗	直肠恶性肿瘤##恶性肿瘤免疫治疗
先天性胆道扩张症	先天性胆管扩张
胃食管结合部肿瘤化疗后	食管胃连接部恶性肿瘤##化学治疗
Barrett食管非萎缩性伴糜烂	巴氏食管##食管糜烂
停经202周B超提示胎儿右侧胸腔异常回声	妊娠状态
右额颞叶间变型少突胶质细胞瘤综合治疗后	间变型少突神经胶质细胞瘤##额颞叶恶性肿瘤
右大腿滑膜肉瘤	滑膜肉瘤##下肢恶性肿瘤
右踝腱鞘囊肿	腱鞘囊肿
上颌前牙区骨内埋伏多生牙	多生牙##埋伏牙
胃无力症	胃麻痹
左手麻木伴右腿无力待查	肌无力
停经242周B超提示胎儿左侧膈肌显示不清	妊娠状态
高CA125神经元特异性烯醇化酶血症	CA125升高##肿瘤标记物升高
肌弛缓先天性奥本海姆氏病	先天性肌弛缓综合征[松软儿]
人类免疫系统缺陷病毒初筛阳性	人类免疫缺陷病毒阳性[HIV阳性]
肺中分化腺癌	肺恶性肿瘤##腺癌
腹盆腔巨大包快	盆腔肿物##腹腔占位
心功能1级(KILLIP分级)	KillipI级
右肺胸水	胸腔积液
动脉硬化(颈动脉斑块)	颈动脉硬化
包皮过长伴粘连	包皮过长##包皮粘连
左睾丸回缩	回缩睾丸
肝区管状腺瘤乙状结肠符合腺瘤性息肉	乙状结肠良性肿瘤##管状腺瘤##乙状结肠息肉##腺瘤样息肉
右肺少许增生的梭行细胞伴异性考虑恶性	右肺恶性肿瘤
食管溃疡型鳞形细胞癌	食管恶性肿瘤##鳞状细胞癌
胸壁软组织挫裂伤	胸壁挫伤
右侧顶枕区病变脱髓鞘脑缺血	脱髓鞘性脑病##脑血管供血不足
龈口炎	龈炎##口炎
肛门Paget病	乳房以外的佩吉特病##肛门恶性肿瘤
躯体化障碍中度焦虑轻度抑郁	焦虑状态##抑郁状态
急性髓系白血病M5B	急性单核细胞性白血病(M5型)
子宫内膜息肉手术史	子宫内膜息肉##子宫术后
多发性腔隙梗塞陈旧性	腔隙性脑梗死##多发性脑梗死
左侧口角撕裂伤伴组织缺损	唇和口腔开放性损伤
右肾异位肾	肾异位
妊娠39+4周，孕2产0，GDM	孕39周##妊娠期糖尿病
外阴色素沉积	色素沉着未特指的疾患
多部位淋巴结继发癌	多部位淋巴结继发恶性肿瘤
肿瘤标志物异常	肿瘤标记物升高
左胫腓骨骨折术后	小腿骨折##骨折术后
右足跟麻木3天神经病变	未特指的多神经病
大便质粘不畅	其他大便异常
纵隔2-7组、右肺门、左侧锁骨上淋巴结转移	纵隔淋巴结继发恶性肿瘤##肺门淋巴结继发恶性肿瘤##锁骨上淋巴结继发恶性肿瘤
药物疹（阿莫西林舒巴坦）	药物性皮炎[药疹]
脐周间断性隐痛待查	腹痛
胼胝体及双侧侧脑室后角异常信号影	"颅骨和头诊断性影像检查的异常所见,不可归类在他处者"
右顶颅骨膜血窦	颅骨膜窦
卵巢高级别浆液性癌	卵巢恶性肿瘤##浆液性癌
右肘部擦皮伤	上肢浅表擦伤
悬雍垂过长	悬雍垂过长
糖尿病胰岛素抵抗	糖尿病性胰岛素抵抗
结肠脾区直肠管状腺瘤	结肠脾曲良性肿瘤##直肠良性肿瘤##管状腺瘤
多发缺血性白质脱髓鞘改变	脱髓鞘性白质脑病##脑血管供血不足
骨纤维异样增殖症(下颌骨)	颌骨纤维异常增殖症
毛发过多	多毛症
左手II-V指部分坏死左上臂皮肤坏死	上肢皮肤坏死##手坏死
酒精中毒？	乙醇中毒
支气管扩张并感染（右肺中叶）；	支气管扩张症##肺部感染
咨询;骨质疏松	骨质疏松
右胫骨外上髁及股骨外侧髁撕脱性骨折	胫骨外髁骨折##股骨外髁骨折
胃胀大便不畅	胃胀气##排便困难
外院两次B超均提示早孕宫内暗区	妊娠状态
双下肺肺炎	肺炎
瘢痕性秃发烧后	瘢痕性脱发[瘢痕性毛发缺失]
手脚发麻待查周围神经病变	多发性神经病[多发性神经炎/周围神经炎]
左侧肢体周围神经病变	多发性神经病[多发性神经炎/周围神经炎]
输卵管癌ⅢC期	输卵管恶性肿瘤##癌
1.大便异常待诊：肠肿瘤？直肠炎？炎症性肠病？	其他大便异常##直肠炎
肾区疼痛	疼痛
安装心脏起搏器（含双室起搏、心室同步起搏、体内除颤）	具有心脏起搏器状态
右冠脉远端陈旧性闭塞病变球囊扩张及支架置	冠状动脉支架植入术后状态
"血管紧张性头痛,海绵状血管瘤，睡眠障碍,高血压病"	血管性头痛##海绵状血管瘤##睡眠障碍##高血压
前降支中度狭窄伴心肌桥形成	冠状动脉肌桥##冠状动脉狭窄
双膝髌股关节局灶性骨梗死伴髌股关节OA	双侧膝关节骨性关节病##骨坏死
冠脉搭桥术后	冠状动脉搭桥术后
鼻咽恶性肿瘤联合治疗后的随诊检查	鼻咽恶性肿瘤##恶性肿瘤联合治疗后的随诊检查
右前臂皮下血肿伴机化	血肿机化
急性移植物抗宿主反应病上消化道皮肤I度	急性移植物抗宿主病
左肝内胆管结石伴胆管炎、左肝萎缩	肝内胆管结石##胆管炎##肝萎缩
颈部骶尾部跌伤	"颈部损伤##躯干未特指的损伤,水平未特指##跌倒"
鼻炎，传单？	鼻炎##传染性单核细胞增多症[腺性热]
胎儿异位融合肾	肾异位##融合肾
左口角疤痕挛缩粘连	瘢痕挛缩##瘢痕粘连
心脏支架术后	冠状动脉支架植入术后状态
急性脑血管病变	脑卒中
头晕。颈椎病。椎动脉供血不全	头晕##颈椎病##椎-基底动脉供血不全
头晕胀痛	头晕##头痛
胆囊结石切除术后	胆囊结石##胆囊术后
外周神经损害	多发性神经病[多发性神经炎/周围神经炎]
腹膜后淋巴结转移	腹膜后淋巴结继发恶性肿瘤
急性移植物抗宿主反应病4度皮肤肠道肝脏	急性移植物抗宿主病
胃底-贲门浸润性病变恶性病变未排除	胃底及贲门恶性肿瘤
双主动脉弓气管软化伴下段狭窄	先天性双主动脉弓##气管狭窄
反应性精神症病脑精分情感障碍	反应性精神病##精神分裂症##双相情感障碍
右肺小细胞癌Ⅳ期	右肺恶性肿瘤##小细胞癌
左胫腓骨远端粉碎性骨折，脑伤，颅底骨折等	胫骨远端骨折伴腓骨骨折##颅底骨折##创伤性脑损伤
右膝OA游离体半月板	单侧膝关节骨性关节病##膝关节游离体
急性淋巴细胞白血病T细胞型CR1	急性淋巴细胞白血病伴缓解
妊娠合并亚临床甲状腺机能减退	妊娠状态##甲状腺功能减退
双侧颈动粥样硬化伴多发斑块形成	颈动脉粥样硬化
双侧睑袋	下睑袋
慢性支气管炎继发感染;慢性阻塞性肺疾病	慢性支气管炎##感染##慢性阻塞性肺疾病
心律失常心房颤动室性早搏	心律失常##心房颤动[心房纤颤]##室性期前收缩
双侧第五跖骨破坏原因TB双踝韧带炎	骨质破坏##结核感染##韧带炎
掌指(关节)脱位	掌指关节脱位
殴打致头部左膝部受伤	"被别人殴打、踢、拧、咬或抓伤##头部损伤##下肢未特指的损伤,水平未特指"
左髋部肌腱末端病	髋肌腱端病
"左下肢DVT,高血压，高血脂"	下肢深静脉血栓形成##高血压##高脂血症
右腋窝异物院外术后伤口感染	手术后切口感染
周围神经病(多发性)	多发性神经病[多发性神经炎/周围神经炎]
1阴道滴虫复查2肝病	未特指的肝病##阴道毛滴虫病
右下肺斑片影性质待查早期恶性不除外	右肺下叶恶性肿瘤
右肺上叶腺癌化疗后随诊检查	右肺上叶恶性肿瘤##腺癌##化学治疗
遗传性色素沉着消化道息肉	色素沉着未特指的疾患
创伤后应激障碍＋器质性脑病	脑病[器质性脑病]##创伤后应激障碍
主动脉瓣环升主动脉发育差	先天性主动脉弓发育不良##先天性升主动脉发育不良
右肾盂输尿管扩张积水	肾盂扩张##输尿管扩张##肾积水##输尿管积水
左颊粘膜鳞癌术后 T3N1M0	颊黏膜恶性肿瘤##鳞状细胞癌##淋巴结继发恶性肿瘤
双膝盘状半月板	先天性盘状半月板
子宫中分化鳞癌	子宫恶性肿瘤##鳞状细胞癌
不慎自台阶上摔倒致伤左膝部	"下肢未特指的损伤,水平未特指"
颅脑损伤-硬膜下出血	头部损伤##硬膜下出血
冠心病--心功能不全	冠状动脉粥样硬化性心脏病##心功能不全
原发性甲状腺功能减退症（甲状腺囊肿术后甲减）	原发性甲状腺功能减退##甲状腺囊肿##甲状腺功能减退
(上腭肿物)鳞状上皮乳头状瘤伴黏膜慢性炎症改变。	腭良性肿瘤##乳头状瘤##腭粘膜炎症
左侧少量胸水考虑结核性	结核性胸腔积液
乳房Paget病待排复诊	乳房佩吉特病
单睾症	单侧睾丸缺如
车祸伤多发骨折	多发性骨折
双乳腺增生并右乳囊肿形成	乳腺增生##乳腺囊肿
化脓性毛囊周围炎	脓肿性穿掘性头部毛囊周围炎
舌癌(岩)	舌恶性肿瘤##癌
1胸水原因待查2下肢浮肿原因待查	胸腔积液##下肢水肿
双肺气肿并肺大泡形成	肺气肿##肺大疱
右乳上象限浸润性导管癌	乳腺恶性肿瘤##浸润性导管癌
颈腹胸部刀伤总值班签字	颈部开放性损伤##腹部开放性损伤##胸部开放性损伤
代谢性骨病右股骨颅骨病变	代谢性骨病
右侧甲状腺滤泡癌	甲状腺恶性肿瘤##滤泡性癌
甲状旁腺功能减低症	甲状旁腺功能减退
右膝滑膜骨软骨瘤病	骨软骨瘤病##膝关节滑膜良性肿瘤
腰椎间多发盘膨出	腰椎间盘突出
三系下降待查血液系统疾病嗜血综合症	全血细胞减少##噬血细胞综合征
1接触性皮炎2唇炎	接触性皮炎##唇炎
人工股骨头置换术后髋臼磨损	髋关节置换术后
右扁桃体癌综合治疗后	扁桃体恶性肿瘤##癌
停经285周胎儿肺隔离症	妊娠状态##先天性肺隔离症
右肺占位性病变，右肺转移可能	肺占位性病变##肺继发恶性肿瘤
右拇多指	多指
低铁低锌硬膜下少量积液	铁缺乏##锌缺乏##硬膜下积液
卵巢交界瘤术后复发	卵巢交界性肿瘤##卵巢术后
（左侧臀部）软组织化脓性感染	软组织感染
C1-C2水平脊髓内异常病变脱髓鞘可能	脱髓鞘性脊髓病
右肾重度积液右侧输尿管重度积液扩张	输尿管扩张
(十二指肠壶腹部癌)	法特壶腹恶性肿瘤##癌
孕5月+先兆临产	先兆临产##孕20周
新生儿缺血缺氧性脑损伤	新生儿缺氧缺血性脑病
双侧足背软组织劳损	足的其他和未特指部位的扭伤和劳损
子宫颈鳞状细胞癌Ib1期G1-2	子宫颈恶性肿瘤##鳞状细胞癌
从4米高摔下致伤头部	自高处坠落##头部损伤
肝脏细胞轻度脂肪变性	脂肪肝
孕32周G4P1ROA先兆早产	孕32周##先兆早产
心源性疾病呼吸系统疾病结缔组织疾病	结缔组织病
多发性骨髓瘤术后化疗后	多发性骨髓瘤##多发性骨髓瘤##恶性肿瘤术后化疗
自身免疫性疾病NK细胞升高	自身免疫病
癫痫(症状性)	症状性癫痫[继发性癫痫]
髓质海绵肾并双肾钙质沉着	先天性海绵肾##钙质沉着症
B淋巴母细胞性淋巴瘤4期	B淋巴母细胞性白血病/淋巴瘤
右大鱼际皮肤软组织裂伤伴动脉损伤	手部开放性损伤##腕和手血管损伤
呼吸不畅查因COPD	呼吸困难##慢性阻塞性肺疾病
右内踝玻璃割伤	踝部开放性损伤##玻璃割伤
外伤后瘢痕	瘢痕
颈管炎宫内膜炎	子宫内膜炎##子宫颈炎
口角割伤	口腔和咽喉部损伤
"食管鳞癌术后,高血压,白细胞低下,放疗呕吐、食欲下降,成人不能进食,咳嗽、痰不易咳出"	食管术后##食管恶性肿瘤##鳞状细胞癌##高血压##白细胞减少##恶性肿瘤放疗##呕吐##食欲不振##进食障碍##咳嗽
右室双腔心改变	右室双腔心
桡骨骨折不愈合	桡骨骨折
右侧面横裂巨口症	颅面裂
溃疡型中低分化腺癌	腺癌
孕34+4周孕1产0左枕；羊水过少？	孕34周##羊水过少
原发性腋窝多汗症	多汗症
双足扁平足双膝关节OA	双侧膝关节骨性关节病##扁平足
左髋股骨异常纤维增殖症	股骨纤维结构不良
经典型霍奇金淋巴瘤IV期B 结节硬化型  侵及右颈部、双锁骨区、前纵隔、右胸肌间、右腋窝、双侧膈区、左內乳区淋巴结  侵及骨（多发）	结节硬化型经典霍奇金淋巴瘤
食管-胃交界处溃疡型管状腺癌根	食管胃连接部恶性肿瘤##管状腺癌
右肘肱骨外髁骨不连	肱骨骨折不连接
"腹痛(胆石症,胆囊炎?)"	胆囊炎##腹痛##胆石症
左环指指背部分皮肤撕脱伴部分坏死	手指开放性损伤##手坏死
左足第四趾肿物，恶黑？	足肿物##恶性黑色素瘤##恶性黑色素瘤
胰体癌	胰体恶性肿瘤##癌
主动脉弓缩窄心功能低下	心功能不全##主动脉缩窄
过敏性浮肿	过敏反应##水肿
大泡性表皮松解坏死型药疹	莱尔综合征[lyell综合征]
非重症免疫相关性血三系减少症	免疫相关性血细胞减少症（IRP）
亚急性皮肤型红斑狼疮	皮肤红斑狼疮
月经不调HPV阳性宫颈CINI	月经紊乱##宫颈人乳头瘤病毒感染##子宫颈上皮瘤样病变[CIN]I级
精神运动神经发育迟缓	发育迟滞
胆总管狭窄，塑料支架术后	胆总管狭窄##胆管支架置入术后
左侧咽部挫裂伤	咽部挫伤
G2P1孕40+2周ROA平产、地中海贫血、中度贫血	头位顺产##地中海贫血##中度贫血
双乳良性囊肿个别导管扩张	乳腺导管扩张症##乳腺囊肿
直肠送检大肠粘膜呈绒毛状-管状腺瘤	直肠良性肿瘤##管状绒毛状腺瘤
右肺鳞癌 cT4N3M1 Ⅳ期	右肺恶性肿瘤##鳞状细胞癌##淋巴结继发恶性肿瘤
甲状腺乳头状微癌	甲状腺恶性肿瘤##乳头状微小癌
左下叶开口非小细胞Ca考虑鳞状细胞Ca	左肺下叶恶性肿瘤##非小细胞癌##鳞状细胞癌
肩背拉伤	"肩部损伤##躯干未特指的损伤,水平未特指"
胃角溃疡型管状腺癌（pT4N1M0 IIIa期）	胃恶性肿瘤##管状腺癌
孕3产3孕35周已娩	正常分娩
鼻咽放疗后	鼻咽恶性肿瘤##恶性肿瘤放疗
脓毒症性脑病	脓毒症
脑膜脑膨出	脑膜脑膨出
右环指取除骨折内固定装置	取出骨折内固定装置##指骨骨折
颈7-胸3椎体病变伴不全瘫	颈椎病##不完全性瘫痪##脊椎病
原发病待查继发性色素沉着	色素沉着未特指的疾患
左髋髂骨撕脱性骨折	髂骨骨折##髋关节骨折
2型糖尿病\骨质疏松症	2型糖尿病##骨质疏松
腰4椎体爆破性骨折伴不全瘫	腰椎骨折L4##不完全性瘫痪
耳鸣;腰痛;失眠汗证气阴虚	耳鸣##腰痛##失眠
过敏性鼻咽炎	咽炎##过敏反应
停搏后房室交界性逸搏	心脏停搏##结性逸搏
鼻咽癌未分化型非角化性癌	鼻咽恶性肿瘤
COPD并右肺中叶部张综合征	慢性阻塞性肺疾病##中叶综合征[Brock综合征]
颅内血管狭窄左中重度狭窄右中中度狭窄	动脉狭窄
颈椎病颈椎间盘突出症颈椎管狭窄症	颈椎病##颈椎间盘突出##颈椎管狭窄
完全阴道纵隔	阴道纵隔
慢性萎缩性胃炎伴胆汁反流	慢性萎缩性胃炎##胆汁反流
高血压;冠心病心律失常型;支架术后;前列腺增生	高血压##冠心病心律失常型##冠状动脉支架植入术后状态##前列腺增生
慢乙肝丙肝复诊	慢性乙型病毒性肝炎##慢性丙型病毒性肝炎
骶裂	骶段脊柱裂
多发性硬膜下硬膜外血肿	硬膜下血肿##硬膜外血肿
低钠低钙低氯原因	低钠血症##低氯血症##低钙血症
室性逸搏	室性逸搏性心律
头痛/过敏性鼻炎	头痛##过敏性鼻炎[变应性鼻炎]
恶心纳差待查	恶心##食欲不振
非酒精性脂肪性肝病并肝病胆囊	脂肪肝##未特指的肝病
支气管扩张伴感染合并真菌感染	支气管扩张症合并感染##肺真菌感染
子宫肌瘤并腺肌症	子宫肌腺症##子宫平滑肌瘤
宫颈肥厚	子宫颈肥大
左锁骨骨折术后	锁骨骨折##骨折术后
骶椎病马尾神经受损	马尾损伤
顺产后4天胎盘残留	胎盘部分残留不伴出血
停经303周MR提示胎儿颈椎改变轮状胎盘	妊娠合并轮状胎盘
马凡综合征伴脊柱侧弯畸形	马方综合征[Marfan综合征]##脊柱侧弯
右手发麻正中神经病变	正中神经损害
空蝶鞍垂体受压改变	空泡蝶鞍综合征
舞蹈症小脑病	舞蹈病
腮弓综合征发育筛查	第一、二鳃弓综合征[Goldenhar综合征]
右侧移位迷走锁骨下动脉	迷走锁骨下动脉畸形
乙状结肠癌肝转移姑息术后腹腔淋巴结转移综合治疗后	乙状结肠恶性肿瘤##肝继发恶性肿瘤##腹腔淋巴结继发恶性肿瘤##癌##转移性癌
肝内胆管同描述符合Caroli`s病改变	先天性肝内胆管囊状扩张症[Caroli病]
高血压，冠心病，肾衰，抑郁症	高血压##冠状动脉粥样硬化性心脏病##肾衰竭##抑郁症
停经31周院外B超提示胎儿盆腔囊性回声	孕31周
下颌骨颏部及双侧髁突骨折	下颌骨骨折
颅内支架置入术后	血管支架植入术后状态
右颊部鳞状细胞Ca	颊部恶性肿瘤##鳞状细胞癌
左大腿皮肤软组织撕脱伴潜行剥离	下肢撕脱伤
双肺支气管炎可能性大	未特指的支气管肺炎
周围神经病变失常	多发性神经病[多发性神经炎/周围神经炎]
窦房结功能不全	窦房结功能低下
孕32周G2P0LOA先兆早产	孕32周##先兆早产
四肢出血点原因待查	出血斑点
呼吸道感染(咳嗽)	呼吸道感染##咳嗽
继发性凝血机能异常维生素K依赖型	凝血功能异常##维生素K缺乏
"毛表皮痣?,皮脂腺痣?"	毛痣##皮脂腺痣
右侧颞叶及基底节区脑出血	颞叶出血##基底节出血
右肘部跌伤	上肢损伤##摔伤
粒细胞减少	中性粒细胞减少症
右侧面部麻木原因躯体化障碍不除外	躯体化障碍
胰腺癌并T2椎体、左侧髂骨转移	胰腺恶性肿瘤##癌##O##髂骨继发恶性肿瘤##转移性癌
子宫纤维瘤	纤维瘤
左上叶阴影待查	肺诊断性影像异常
胸椎骨折伴脊髓损害	胸椎骨折##胸部脊髓损伤
十二指肠转移	转移性肿瘤##十二指肠继发恶性肿瘤
结肠肝曲中分化腺癌（pT4aN0M0 IIB期）术后	结肠术后##结肠恶性肿瘤##腺癌
卵圆孔未闭6脑后循环缺血	卵圆孔未闭##后循环缺血
语音异常	语音改变
胎儿异常胎儿部分肠管扩张胎儿透明隔腔增宽	先天性透明隔异常
骶尾部纤维脂肪组织化脓	软组织感染
双肺转移性癌	肺继发恶性肿瘤##转移性癌
腺囊瘤。足癣	足癣
腹部神经性异常感觉	周围神经系统和特殊感觉功能检查的异常结果
左肱二头肌腱断裂	上肢肌肉肌腱断裂
右上肺癌伴全身多发转移（IV期 骨、脑）	右肺上叶恶性肿瘤##多部位继发恶性肿瘤##脑继发恶性肿瘤##骨继发恶性肿瘤##癌##转移性癌
发热;上呼吸道感染?;泌尿道感染?	发热##上呼吸道感染##感染##部位未特指的泌尿道感染
背部擦伤	躯干浅表擦伤
-横结肠绒毛管状腺瘤	横结肠良性肿瘤##管状绒毛状腺瘤
双上眼睑血管瘤	血管瘤
脊柱轻度退变双膝轻度退变	双侧膝关节骨性关节病##脊柱骨关节病
头面颈前胸开水烫伤	沸水烫伤##躯干部烫伤
右枕部静脉畸形	周围静脉畸形
肝肾不足视物不清	视觉模糊
直肠恶性肿瘤(dixon术后 pT3N1M0 IIIB)	直肠恶性肿瘤##直肠术后##淋巴结继发恶性肿瘤
肝交界恶性肿瘤	肝恶性肿瘤
壶腹部中分化腺癌	法特壶腹恶性肿瘤##腺癌
乙状结肠隆起型中分化腺癌	乙状结肠恶性肿瘤##腺癌
骨关节病(右手重度骨关节炎)	重度骨关节病
右侧上颌窦黏膜下囊肿	上颌窦囊肿
慢性轻度丙型病毒性肝炎	慢性丙型病毒性肝炎
回盲部溃疡	肠溃疡
2左侧11肋后肋骨折	肋骨骨折
胚胎移植后宫内早孕合并宫外孕	胚胎移植术后##异位妊娠
高热惊厥Sturge-weber综合症	热性惊厥##脑面血管瘤病[Sturge-Weber综合征]
主动脉缩窄	主动脉缩窄
腰背部脂肪堆积症	腰部脂肪增多症##背部脂肪增多症
黄斑变性术后	黄斑变性##眼术后
内耳眩晕症	耳源性眩晕
先天性胆管囊样扩张症	先天性胆管扩张
皮肤软组织撕脱并缺损	皮肤缺损
右下颌骨成釉细胞瘤	下颌骨良性肿瘤##成釉细胞瘤
创伤性胰腺断裂	胰腺破裂
腹膜后肿物肿物	腹膜后肿物
先天性紫绀四联症	先天性心脏病##法洛四联症
1.不全流产	"未特指的流产,不完全性,无并发症"
心辨膜置换术	具有其他心脏瓣膜置换
工伤骨折骨关节病关节痛	工作中的意外损伤##骨折##骨关节病##关节痛
右小腿蜂蜇伤	蜂螫伤##小腿损伤
颈脊椎病	颈椎病
腰腹疼	腰痛##腹痛
急性ST段抬高型心肌梗死下壁	急性ST段抬高型心肌梗死##急性下壁心肌梗死
后循环缺血可能性大神经肌肉病变待排除	后循环缺血
腰4骨破坏	骨质破坏
肝恶性肿瘤(（胸腰椎转移，左侧股骨）)	肝恶性肿瘤##O##股骨继发恶性肿瘤##转移性肿瘤
双右耳突发性耳聋左耳感音神经性耳聋	单侧感音神经性聋##突发性聋
桥本氏甲状腺病3梅尼尔综合征	自身免疫性甲状腺炎[桥本病]##梅尼埃病
双足跟骨骨折	跟骨骨折
胎儿异常三倍体	三倍体和多倍体##胎儿染色体异常
A67C67D8龋齿B45楔状缺损	牙齿楔状缺损##龋病
右乳腺癌术后伴右颈部多发淋巴结	乳腺术后##乳腺恶性肿瘤##颈部淋巴结继发恶性肿瘤
乙状结肠腺瘤伴高级别上皮内瘤变	乙状结肠良性肿瘤##腺瘤
左足平足症左后踝撞击症	踝关节撞击综合征##扁平足
结核性脊柱弯曲波特氏弯曲	结核感染##脊柱畸形
腰部皮肤擦伤	躯干浅表擦伤
上消化道出血待查：溃疡？	上消化道出血##消化性溃疡
左乳癌可疑肺M，CT3N2Mx luminal B2	乳腺恶性肿瘤##癌##肺继发恶性肿瘤##转移性癌##淋巴结继发恶性肿瘤
肺内占位待查－－肺癌	肺占位性病变##肺恶性肿瘤##癌
多脏器功能不全肝肾肌酶凝血	多脏器功能障碍综合征[MODS]
胃病	胃和十二指肠未特指的疾病
前列腺癌(术后)	前列腺恶性肿瘤##癌##前列腺术后
晕厥待查：心源性？癫痫？单纯性？	晕厥##癫痫##心源性晕厥
室性自搏心律	室性自搏
胃隆起性病变SMTCa	胃恶性肿瘤##癌
高免疫球蛋白EIGE综合征	高lgE综合征
面部皮肤红肿过敏	过敏反应
痛风肾病	痛风##肾病
意识不清待查肝脑可能性大	肝性脑病##意识障碍
双膝关节滑膜软骨瘤病	膝关节滑膜良性肿瘤##软骨瘤病
食管癌小细胞型	食管恶性肿瘤##癌
腹痛-胃肠功能紊乱	腹痛##胃肠功能紊乱
胸椎腰椎多发性压缩性改变	胸椎压缩性骨折##腰椎压缩性骨折
十二指肠降段胃体胃窦贲门增生性息肉	胃和十二指肠息肉
停经345周B超提示胎儿双侧肾窦中度分离	妊娠状态
左肺见增生纤维胶原及真菌菌丝	肺真菌感染##肺纤维化
贲门鳞癌	贲门恶性肿瘤##鳞状细胞癌
新生儿低球蛋白血症	低丙球蛋白血症
十二指肠球部多发性隆起病变	胃和十二指肠未特指的疾病
阑尾开口横结肠管状腺瘤	管状腺瘤##横结肠良性肿瘤
右上腭及右扁桃体经典霍奇金淋巴瘤化疗后	经典型霍奇金淋巴瘤##扁桃体淋巴瘤##化学治疗
胸椎小关节功能紊乱	胸椎小关节功能紊乱
口底占位性病变	口腔和咽喉部占位
尿不尽尿潜血阳性排尿无力	其他排尿困难
皮肤白斑上呼吸道疾病	"白斑病,不可归类在他处者##未特指的上呼吸道疾病"
左足反复破溃伤口不愈除外骨质改变	足部损伤##开放性损伤愈合不良
特指胎盘疾病胎膜残留	其他的胎盘疾患##胎盘部分残留不伴出血
右肺上叶鳞癌放化疗后	右肺上叶恶性肿瘤##鳞状细胞癌##恶性肿瘤放疗##化学治疗
腰椎管狭窄伴不全瘫	腰椎管狭窄##不完全性瘫痪
脑蛛网膜炎	蛛网膜炎
闭合性颅脑损伤：轴索伤？	头部损伤##弥漫性轴索损伤
多发子宫平滑肌瘤	子宫多发性平滑肌瘤##子宫平滑肌瘤
不完全右束支阻滞并左前分支阻滞	不完全性右束支传导阻滞##左前分支传导阻滞
多囊肾合并感染	先天性多囊肾##肾感染
右前臂烧伤2%III°	上肢三度烧伤
手足汗多	多汗症
胸段硬膜下自发性血肿伴不全瘫	硬脊膜下血肿##不完全性瘫痪
结肠MTlater术后，前列腺MT术后，腹主动脉血管瘤术后	结肠术后##结肠恶性肿瘤##前列腺恶性肿瘤##前列腺术后##腹主动脉瘤
心慌气短	心悸##气短
右乳浸润性导管癌T3N0M0	乳腺恶性肿瘤##浸润性导管癌
溶血性尿毒性综合症	溶血-尿毒综合征
冠心病陈旧性心梗？;脑梗塞	冠状动脉粥样硬化性心脏病##陈旧性心肌梗死##脑梗死
右侧睾丸未降？	睾丸未降
NSE神经元特异性烯醇化酶异常升高	肿瘤标记物升高
膀胱过度活动综合征	膀胱过度活动症
右卵巢浆液性腺癌	卵巢恶性肿瘤##浆液性腺癌
急性非淋巴细胞白血病-M5a	急性非淋巴细胞白血病##急性非淋巴细胞性白血病
右输尿管结石右肾积水	肾积水伴输尿管结石
腹痛待查要求取环	腹痛
猝死型冠心病	心源性猝死##冠状动脉粥样硬化性心脏病
血液化学特指异常所见TPSA升高	肿瘤标记物升高
十二指肠占位伴梗阻	十二指肠梗阻##肠占位
右手骨关节炎	骨关节病
骨关节病(腘窝囊肿)	腘窝囊肿##骨关节病
脊髓空洞伴不全瘫	不完全性瘫痪##脊髓空洞症
左示指陈旧性完全缺如	创伤性手指缺如
右肺小细胞癌化疗后伽玛刀治疗后	右肺恶性肿瘤##小细胞癌##化学治疗
其他诊断完全性肺静脉异位引流——混合型	"完全性肺静脉异位引流,混合型"
L1椎体陈旧性压缩性骨折	陈旧性腰椎骨折##腰椎骨折L1
阴道前壁脱出II度子宫脱出I度	子宫脱垂I度##阴道前壁脱垂
右下肢多形性未分化肉瘤	肉瘤##下肢恶性肿瘤
右手示环指左腕部玻璃割伤	手指开放性损伤##腕部开放性损伤##玻璃割伤
腰间盘突出伴椎管狭窄	腰椎间盘突出##腰椎管狭窄
鳞状细胞癌浸润	鳞状细胞癌
低钾低钠底钙血症	低钾血症##低钠血症##低钙血症
心率失常并心肌缺血	心肌供血不足##心律失常
双乳腺溢液待查1乳管扩张	乳腺导管扩张症##乳头溢液
大疱表皮松解萎缩坏死型药疹	莱尔综合征[lyell综合征]
扁桃体损伤	口腔和咽喉部损伤
左胸壁占位	胸部占位
贲门低分化腺癌	贲门恶性肿瘤##腺癌
"原发性肝癌;慢性乙型病毒性肝炎,肝硬化;"	肝恶性肿瘤##慢性乙型病毒性肝炎##肝硬化##癌
子宫腺肌症内膜异位症	子宫肌腺症##子宫内膜异位
荨麻疹伴感染	荨麻疹##感染
肝胆管占位	胆管占位性病变
左胸积液胸水结核性	结核性胸腔积液
宫颈中分化鳞癌IIB期放化疗后	子宫颈恶性肿瘤##鳞状细胞癌##化学治疗##恶性肿瘤放疗
结膜色素斑	色素斑
下颌面发育不全	先天性颅面发育不全
病毒性肝炎乙型慢性重型	病毒性肝炎乙型慢性重度
胆囊癌/肝脏转移	胆囊恶性肿瘤##癌##肝继发恶性肿瘤
左小腿皮肤剥脱撕裂伤	小腿撕脱伤
史蒂文斯-约翰逊二氏病糜烂性多形	史蒂文斯-约翰逊综合征
口咽鳞状细胞癌化疗后	口咽恶性肿瘤##鳞状细胞癌##化学治疗
部分性发作继发全面性发作	癫痫
治疗使产程延迟的胎膜早破	"胎膜早破,由于治疗而使产程延迟"
双眼结膜炎、左眼霰粒肿术后	结膜炎##睑板腺囊肿[霰粒肿]##眼术后
椎间盘脱出症	其他的颈椎间盘移位
胸12椎体陈旧性病变	脊椎病
回肠腺癌术后第4次化疗	回肠术后##回肠恶性肿瘤##腺癌##恶性肿瘤术后化疗
继发性前庭功能损害	前庭功能未特指的疾患
"右上肺肿物,肺癌"	右肺上叶恶性肿瘤##癌##肺肿物
前列腺腺瘤	前列腺良性肿瘤##腺瘤
右肺小细胞癌局限期	右肺恶性肿瘤##小细胞癌
热液烫伤双足	足部烫伤
手指肌断裂(术后)	手部肌肉肌腱断裂
直肠癌术后 肺转移	直肠术后##直肠恶性肿瘤##癌##肺继发恶性肿瘤##转移性癌
左肾轻-中度受损	肾损伤
大便次数减少直肠局部隆起	大便习惯改变
左乳腺癌术前化疗	乳腺恶性肿瘤##癌##恶性肿瘤术前化疗
右肾输尿管膀胱部分切除	肾术后##输尿管术后##膀胱术后
退行性心瓣膜病变	心脏瓣膜病
眼眶骨瘤	眶骨良性肿瘤
多发性周围神经损害	多发性神经病[多发性神经炎/周围神经炎]
肾透明细胞癌伴囊性变	肾恶性肿瘤##透明细胞癌
颈腰部疼痛待查	颈痛##腰痛
脑病并吞咽功能丧失	未特指的脑病##吞咽障碍
肠梗阻治疗后	肠梗阻
右下肺腺癌	右肺下叶恶性肿瘤##腺癌
维生素D缺乏性骨软化	维生素D缺乏##骨软化症
胃癌化疗后/恶心食欲不振	胃恶性肿瘤##恶心##食欲不振##癌##化学治疗
上段食管鳞状细胞癌	食管上三分之一的恶性肿瘤##鳞状细胞癌
"食管癌术后pT3N1 放化疗 白细胞低下,恶心呕吐,血小板低,放射性食管炎,疼痛"	食管术后##食管恶性肿瘤##恶性肿瘤术后放疗##恶性肿瘤术后化疗##白细胞减少##恶心和呕吐##血小板减少##放射性食管炎##疼痛##癌
软组织感染;动脉粥样硬化并高脂血症;冠状动脉粥样硬化性心脏病;周围神经病;慢性支气管炎;贫血	软组织感染##动脉粥样硬化##高脂血症##冠状动脉粥样硬化性心脏病##O##慢性支气管炎##贫血
扁桃体及腺样体组织慢性炎伴淋巴组织增生	扁桃体和腺样体未特指的慢性疾病##淋巴组织增生
腹腔多发淋巴结肿大转移可能	腹腔淋巴结肿大##腹腔淋巴结继发恶性肿瘤
吞咽发呛咽梗	吞咽困难
右心房扩大	心房扩大
上颌前牙区埋伏多生牙	埋伏牙##多生牙
高癌胚抗原血症	CEA升高
主动脉动脉硬化	主动脉硬化
注意力缺乏障碍或综合征	注意缺陷与多动障碍
急性脑梗死右侧额颞顶枕叶多发梗塞	脑梗死##多发性脑梗死
肾上腺腺瘤 儿茶酚胺增多症	肾上腺良性肿瘤##腺瘤##儿茶酚胺分泌过多
糖尿病性感觉运动性周围神经病变	糖尿病性感觉运动性周围神经病
脊柱裂伴脑积水	未特指的脊柱裂伴脑积水
糖尿病性神经炎(反复发作低血糖)	糖尿病##神经炎##低血糖
右乳癌术前新辅助化疗后	乳腺恶性肿瘤##化学治疗##癌
抗心磷脂综合症	抗磷脂综合征
心脏植物精神功能紊乱	心脏神经症
骨髓穿刺组织示嗜酸性造血细胞轻度增生	嗜酸粒细胞增多
淋巴瘤治疗后的随诊检查	淋巴瘤##淋巴瘤
右腋下皮脂腺囊肿待病理	皮脂腺囊肿
腰5-骶1病变伴双下肢不全瘫	截瘫[双下肢瘫痪]##不完全性瘫痪
胸水原因胸腹腔膈肌瘘	胸腔积液
腹膜后小细胞恶性肿瘤	腹膜后恶性肿瘤##小细胞型恶性肿瘤
急性喉炎-支炎	急性喉气管炎
右膝陈旧性损伤	"下肢未特指的损伤,水平未特指"
无精症双侧精囊缺如	无精子症
头颈肩部痛	头痛##颈痛##肩痛
左前臂广泛肌肉缺血坏死	上肢供血不足
骨质疏松；乳腺癌；末梢神经炎	骨质疏松##乳腺恶性肿瘤##末梢神经病[末梢神经炎]##癌
左乙状窦横窦狭窄颅内多发腔隙性梗死	腔隙性脑梗死##多发性脑梗死
左足皮肤肿瘤	足部肿瘤
胆囊胆固醇样息肉	胆囊息肉
右卵巢低分化腺癌Ⅰc期	卵巢恶性肿瘤##腺癌
胰头穿刺物坏死组织中及散在少数异型腺体	胰坏死
腹部伤口愈合不良	开放性损伤愈合不良
卵巢浆液性腺癌IIIC期	卵巢恶性肿瘤##浆液性腺癌
慢性支气管炎并感染	慢性支气管炎##感染
妊娠26周孕3产1先兆流产	孕26周##先兆流产
2双下肢股骨头坏死	股骨头缺血性坏死
右下肺病灶性质待查陈旧病灶	肺诊断性影像异常
A2B1半脱位A1根折	牙脱位##牙折断
直肠粘液腺癌	直肠恶性肿瘤##粘液腺癌
脑外伤后神经症颅内器质性病变待除外	神经症性障碍
"肝细胞性肝癌术后,慢性乙型肝炎活动期,血小板减低,脾功能亢进"	肝术后##肝细胞癌##慢性乙型病毒性肝炎##慢性活动性肝炎##血小板减少##脾功能亢进
结肠肝曲管状腺瘤局部上皮中度不典型	结肠肝曲良性肿瘤##管状腺瘤
双颊舌粘膜扁平苔藓	口腔扁平苔癣##舌扁平苔癣
直肠肿物性质待查:直肠癌	直肠恶性肿瘤##癌##直肠肿物
宫内早孕	妊娠状态
腰椎病胸椎病	腰椎病
右膝关节外翻畸形	膝外翻
贲门癌并脾静脉癌栓	贲门恶性肿瘤##肿瘤栓子##癌
狼疮间质性肺损害	系统性红斑狼疮##间质性肺病
前列腺癌恶性肿瘤	前列腺恶性肿瘤##癌
慢性肾脏病矿物质和骨异常	慢性肾病##矿物质代谢紊乱
白斑病	"白斑病,不可归类在他处者"
双下肢浅静脉曲线伴小腿色素沉着	下肢静脉曲张##皮肤色素沉着
肛管末端代谢局灶性增高考虑为痔疮可能性大	痔
多发肝低密度灶Caroli病	先天性肝内胆管囊状扩张症[Caroli病]
胃底病变内镜粘膜下剥离术	胃和十二指肠未特指的疾病
PSVT	阵发性室上性心动过速
慢性病引起的贫血	分类于他处的其他慢性疾病引起的贫血
继发性抗磷酯综合征	抗磷脂综合征
运动神经元疾病	运动神经元病
脑内少量小脱髓鞘斑	脱髓鞘性脑病
糖尿病反复低血糖;骨质疏松;高血压冠心病不稳定心绞痛	糖尿病性低血糖症##骨质疏松##高血压##冠状动脉粥样硬化性心脏病##不稳定性心绞痛
64龋(牙)	龋病
颈部血粥样管粥样硬化	颈动脉粥样硬化
右足背轧伤	足部挤压伤
右颌下粘液囊肿伴导管囊性扩张右颌	下颌下腺粘液囊肿
非酒精性单纯性脂肪性肝病	脂肪肝
双足癣菌病	足癣
左腋下淋巴结放疗后	放射治疗
肺部感染(重症)	肺部感染
狼疮累及膀胱	"系统性红斑狼疮,累及器官或系统"
多脏器功能不全累及肝脏血液心肌	多脏器功能障碍综合征[MODS]
腹白线疝 腹腔镜术后	腹白线疝
胃贲门低分化腺癌	贲门恶性肿瘤##腺癌
糖尿病糖尿病周围神经病变糖尿病肾病IV期	糖尿病##糖尿病性周围神经病##糖尿病肾病IV期
双侧颈内动脉支架植入术后	周围血管支架植入术后状态
低中分化子宫内膜样腺癌	子宫内膜样腺癌##子宫内膜恶性肿瘤
椎动脉支架置入术	血管支架植入术后状态
慢性萎缩性胃炎并糜烂	慢性萎缩性胃炎##糜烂性胃炎
子宫颈中高分化鳞癌维持性化学治疗	子宫颈恶性肿瘤##鳞状细胞癌##恶性肿瘤维持性化学治疗
红细胞G-6-PD缺乏症	葡萄糖-6-磷酸脱氢酶缺乏性贫血
"肺腺鳞癌,脑转移,非小细胞肺癌晚期,化疗止吐,抗过敏"	肺恶性肿瘤##腺鳞癌##脑继发恶性肿瘤##非小细胞癌##肺恶性肿瘤##化学治疗##转移性腺鳞癌
淋巴瘤白血病T细胞型	T淋巴母细胞白血病/淋巴瘤
左股四头肌腱开放性撕脱性骨折	股骨骨折
右肺上叶大细胞癌免疫治疗	右肺上叶恶性肿瘤##大细胞癌##恶性肿瘤免疫治疗
右颊粘膜色素沉着待查	色素沉着未特指的疾患
颈内动脉硬斑	颈动脉硬化
直肠肿块性质待查	直肠肿物
乳腺paget病待除外	乳房佩吉特病
右肺腺癌靶向治疗后	右肺恶性肿瘤##腺癌##恶性肿瘤靶向治疗
食道癌放疗后	食管恶性肿瘤##癌##恶性肿瘤放疗
左舌叶病灶性质待查：肺炎可能，肺癌待排	肺炎##肺恶性肿瘤##癌
高血压血糖增高	高血压##血糖升高
右眼眶外侧、右手腕部外伤	眼和眶未特指的损伤##腕部损伤
食管高分化鳞形细胞癌	食管恶性肿瘤##鳞状细胞癌
结肠癌淋巴结转移	淋巴结继发恶性肿瘤##结肠恶性肿瘤##癌
左肺上叶中央型肺癌IV期纵膈淋巴结肿大	左肺上叶恶性肿瘤##癌##纵隔淋巴结肿大
腹部割伤	腹部开放性损伤
眶内癌	眶内恶性肿瘤##癌
2型糖尿病足感染	2型糖尿病性下肢感染
右侧颞叶动静脉畸形	脑动静脉畸形
盲肠粪石嵌顿穿孔	粪便嵌塞##肠穿孔
左乳腺导管内乳头状肿瘤	乳腺良性肿瘤##导管内乳头状瘤
右手月状骨掌侧脱位	腕舟骨月骨周围脱位
鼻唇沟注射整形后左眼失明	单眼盲
左小腿左足缺血坏死	下肢供血不足##足坏死
慢加急性肝功能衰竭	肝功能衰竭
肝病脑病I期	肝性脑病
大疱性表皮坏死松解萎缩型药疹	莱尔综合征[lyell综合征]
下牙槽神经损伤	身体未特指部位的神经损伤
冠心病;骨质疏松;高血压;脑动脉硬化	冠状动脉粥样硬化性心脏病##骨质疏松##高血压##脑血管硬化
乳腺癌晚期复发	乳腺恶性肿瘤##癌##恶性肿瘤复发
贲门胃体病变内镜粘膜下剥离术	胃和十二指肠未特指的疾病
右肺低分化鳞状细胞癌	右肺恶性肿瘤##鳞状细胞癌
右肘关节骨组织部分呈变性改变	骨病变
脓毒症？症状性腹泻	脓毒症
胸腰椎右侧股骨占位	下肢占位##脊柱占位
右肾盂低级别乳头状尿路上皮癌	肾盂恶性肿瘤##乳头状尿路上皮癌
双眼泡性结膜炎，左眼结膜结石	泡性结膜炎##结膜结石
髓核组织伴部分坏死及钙盐沉积	钙质沉着症
行动不便结肠癌术后化疗	结肠恶性肿瘤##恶性肿瘤术后化疗##癌
双下肢软组织损伤	"下肢未特指的损伤,水平未特指"
贲门癌综合治疗后	贲门恶性肿瘤##癌
右侧股骨头坏死	股骨头缺血性坏死
陈旧性下壁ST段抬高型心肌梗死	陈旧性下壁心肌梗死
腰1椎体后缩性骨折	腰椎骨折L1##腰椎压缩性骨折
双侧基底节区及额叶多发腔隙灶老年脑改变	腔隙性脑梗死
继发性抗磷脂抗体综合征	抗磷脂综合征
顶部头皮放射性坏死缺损	放射性损害
颌面部皮肤擦伤	面部擦伤
淋巴结病(CASTLEMAN病)	Castleman病##淋巴结病
双侧甲状腺癌待排	甲状腺恶性肿瘤##癌
右手小指腱鞘巨细胞瘤	腱鞘巨细胞瘤##手部肿瘤
创伤性脊椎病	创伤后脊椎病
淀粉样变肝损害	淀粉样变肝损害
阵发性夜间血红蛋白尿(马尔基亚法瓦-米凯利)	阵发性睡眠性血红蛋白尿
颈胸椎发育畸形	先天性颈椎畸形##先天性胸椎畸形
高血压病极高危组	高血压
系统性硬皮病相关肺间质病	系统性硬化症##间质性肺病
颈部增生性瘢痕	颈部瘢痕
家族性遗传性慢性天疱疮	良性慢性家族性天疱疮
化疗肾母细胞瘤	肾恶性肿瘤##肾母细胞瘤##化学治疗
M蛋白血症意义未明的单株免疫球蛋白血症	意义未明的单克隆丙种球蛋白病
左侧室管膜下囊肿	室管膜囊肿
子宫内膜癌内分泌治疗后	子宫内膜恶性肿瘤##恶性肿瘤内分泌治疗##癌
结肠癌术后pT3NIb	结肠术后##结肠恶性肿瘤##癌
癫痫持续状态症状性癫痫	癫痫持续状态
原发性肝癌术后复发伴肺、骨多发转移	肝术后##肝恶性肿瘤##恶性肿瘤复发##肺继发恶性肿瘤##骨继发恶性肿瘤##癌
左膝关节运动性劳损	膝的其他和未特指部位的扭伤和劳损
"梗阻性黄疸：胆总管占位？,胆囊占位"	梗阻性黄疸##胆管占位性病变##胆囊占位性病变
胸椎骨质破坏待诊T10	骨质破坏
垂体性分离偏斜双	垂直分离性斜视[DVD综合征]
右肾囊肿内伴结石	肾结石##肾囊肿
左手中指指背皮肤挫裂及缺损	手指挫伤##皮肤缺损
横结肠癌术后pT3N2M0IIIC期pMMR	结肠术后##横结肠恶性肿瘤##癌
卵巢成熟性畸胎瘤	卵巢良性肿瘤##成熟型畸胎瘤
右肩背部咬伤	肩部开放性损伤##背部开放性损伤
左眼带状疱疹	带状疱疹眼病
胸腹腰臀部多处刀伤	多处损伤
早孕；牙痛	妊娠状态##牙痛
左侧额颞顶硬膜下积液右侧额颞硬膜下积液	硬脑膜下积液
胸腰椎间盘退行性病变	腰椎退行性病变##胸椎退行性病变
宫颈癌ⅡB放疗	子宫颈恶性肿瘤##放射治疗##癌
Z足癣感染药疹	足癣##药物性皮炎[药疹]##足感染
躯体阵挛待查	痉挛
右侧胫腓骨骨折	腓骨骨折##胫骨骨折
1多发性腔隙性梗塞	腔隙性脑梗死##多发性脑梗死
血象升高原因待查1血液系统疾病2其他	血液和造血器官未特指的疾病
右上颌窦内翻乳头瘤术后	鼻窦占位
二尖瓣置换状态	具有其他心脏瓣膜置换
右乳多发导管内乳头状瘤	导管内乳头状瘤##乳腺良性肿瘤
中枢脱髓鞘疾病播脑后遗症	未特指的中枢神经系统脱髓鞘病
双肺间质性改变伴轻度纤维化	肺间质纤维化
急性脑梗死；高血压病；心肌缺血	脑梗死##高血压##心肌供血不足
右肺转移伽马刀治疗后	肺继发恶性肿瘤##恶性肿瘤放疗
左侧距骨副骨或撕脱性骨折可能	距骨骨折
右眼视障待查缺血	视觉障碍##眼动脉缺血
糖尿病视网膜病变左眼增殖期	糖尿病性增殖性视网膜病
右乳浸润性导管癌术后化疗(pT	浸润性导管癌##乳腺恶性肿瘤##恶性肿瘤术后化疗
右侧肢体发僵流涎待查	流涎症##肢体僵硬
慢性支气管炎行动不便	慢性支气管炎
左外踝韧带撕脱性骨折	外踝骨折
顽固性座疮心脾气阴两虚	痤疮
颧部褐青色斑	真皮痣
肺血管性疾病	肺血管未特指的病
低钙拇外翻	钙代谢紊乱
乳糜胸腹水	乳糜胸##腹水
肛周小细胞恶性肿瘤术后	小细胞型恶性肿瘤##肛周肿瘤
左眼上睑急性睑腺炎、急性化脓性结膜炎	睑腺炎[麦粒肿]##急性结膜炎
右下肢溃疡伴感染	下肢溃疡##下肢软组织感染
低级别滤泡性淋巴瘤IV期B组	滤泡淋巴瘤
先天性喉软骨发育不良	先天性喉软骨软化病
创伤性急性硬膜外下血肿	急性创伤性硬脊膜下血肿##硬脊膜外血肿
妊娠期亚临床甲状腺功能减退	妊娠状态
"高血压,高脂血症,骨质疏松,结肠癌"	高血压##高脂血症##骨质疏松##结肠恶性肿瘤##癌
右基底节梗塞灶亚急性左基底节陈旧	基底节脑梗死
脑神经脱髓鞘样改变	脱髓鞘性脑病
右脚肿块	足肿物
左鼻空疤痕挛缩狭窄	瘢痕挛缩##鼻部瘢痕
咽部异物待排咽部溃疡	咽内异物##咽喉溃疡
上腹隐痛	上腹痛
巨脾脂质组织细胞增多症Gaucher病	脑苷脂贮积综合征[戈谢病]
早孕哺乳期核对孕周疤痕子宫两次	瘢痕子宫##妊娠状态
冠心病高血压贫血高脂血症胃炎脑梗塞便秘脂肪肝心律失常上呼吸道感染	冠状动脉粥样硬化性心脏病##高血压##贫血##高脂血症##胃炎##脑梗死##便秘##脂肪肝##心律失常##上呼吸道感染
颈部淋巴结继发癌	颈部淋巴结继发恶性肿瘤
食指近节关节囊破裂并关节面部分缺失	手指损伤
右手小指神经肌腱血管断裂	腕和手血管损伤##手部肌肉肌腱断裂##手部神经断裂
胆总管末端粘液腺癌	胆总管恶性肿瘤##腺癌
弓形虫病	未特指的弓形虫病
宫颈中分化腺癌IB1期	子宫颈恶性肿瘤##腺癌
椎体压缩骨折（T12）	胸椎压缩性骨折
胎儿颅后窝液体增宽胎儿一侧肾缺如	先天性单肾
髌(骨软)骨软化(待查)	髌骨软骨软化
移植肝内胆管增宽	肝移植状态
腰骶关节劳损	腰椎和骨盆其他和未特指部位的扭伤和劳损
右膝关节肿块	膝关节肿物
内耳特指疾病左侧内耳迷路积水	膜迷路积水##内耳未特指的疾病
混合痣	痣
"G2P1孕36+1周待产LOA,胎膜早破，疤痕子宫"	孕36周##胎膜早破##瘢痕子宫
双侧额顶叶深部白质轻度脱髓鞘改变	脱髓鞘性白质脑病
左卵巢纤维瘤	纤维瘤
膝部软组织损伤	"下肢未特指的损伤,水平未特指"
低钾周瘫	低钾型周期性瘫痪[低血钾性周期性麻痹/家族性周期性瘫痪]
子宫切除术后	子宫术后
输尿管结石碎石取石术后	输尿管结石##输尿管术后
肝内胆汁淤积	胆汁淤积症
双肺炎症并双侧胸腔积液	肺炎##胸腔积液
有右侧甲状腺乳头状癌	甲状腺恶性肿瘤##乳头状癌
特殊检查左乳突肿左枕骨下肿	头部肿胀
右中指末节开放伤伴指深屈肌腱指神经损伤	手指开放性损伤##指神经损伤##手部肌肉肌腱损伤
冠心病心绞痛缺血性心肌病	冠状动脉粥样硬化性心脏病##心绞痛##缺血性心肌病
阴茎发育异常	先天性阴茎发育不全
脑炎后遗症	脑炎后综合征
右手第三掌骨脱位第二掌骨小多角骨脱位	掌指关节脱位
鼻咽未分化型非角化性癌综合治疗后	鼻咽恶性肿瘤##未分化的癌
下肢动静脉畸形	先天性动静脉畸形
右眼外眦部鳞状细胞Ca	外眦恶性肿瘤##鳞状细胞癌
少量变性坏死组织符合化疗后改变	化疗药物反应
慢性肾衰竭尿毒症	慢性肾衰竭尿毒症期
急性呼吸窘迫综合症（重度）	急性呼吸窘迫综合征
双侧卵巢浆液性腺癌	卵巢恶性肿瘤##浆液性腺癌
左侧后腹膜考虑Castleman病	Castleman病
下颌瞬目综合征左	下颌瞬目综合征[MarcusGunn综合征]
血管瘤 右侧大腿内侧	肢体血管瘤
S1椎体结核	脊柱结核
血脂高血脂高	高脂血症
左小腿及左足广泛皮肤软组织剥脱伴缺损	足部软组织撕脱伤
慢性心衰急性加重心功能Ⅲ级	心功能III级(NYHA分级)##慢性心力衰竭
双卵巢高级别浆液性腺癌IIIc期	浆液性腺癌##双侧卵巢恶性肿瘤
慢性阻塞性肺病伴急性加重伴双肺肺炎	慢性阻塞性肺疾病急性加重##肺炎
纵隔癌	纵隔恶性肿瘤##癌
胸髓病变T9完全横贯性损害梗死	脊髓病##急性脊髓梗死
左冠前降支心肌桥伴粥样硬化斑块	冠状动脉肌桥##冠状动脉粥样硬化
房水平局限性左向右分流小房缺或卵圆孔未闭	卵圆孔未闭##房间隔缺损
小肠恶性肿瘤(术后 透明细胞肉瘤)	小肠恶性肿瘤##透明细胞肉瘤
肋骨骨纤维异样增殖症	肋骨纤维异常增殖症
双侧背部软组织拉伤	"躯干未特指的损伤,水平未特指"
卵巢交界性肿瘤术后复查	卵巢交界性肿瘤##卵巢术后
W55x00被其他哺乳动物咬伤或抓伤	"被其他哺乳动物咬伤或抓伤,在未特指场所"
直肠腺癌综合治疗后ypT3N0M0ⅡA期	直肠恶性肿瘤##腺癌
卵巢浆液性癌IIIC期G3级	卵巢恶性肿瘤##浆液性腺癌
右肾输尿管结石右肾积水	肾积水伴肾和输尿管结石梗阻
右肾肾萎缩	肾萎缩
右乳低回声区性质待定积乳积脓	乳房脓肿
分娩伴会阴裂伤Ⅰ度	分娩伴会阴裂伤
贲门浅表溃疡型低分化腺癌	贲门恶性肿瘤##腺癌
病头窦综合征	病态窦房结综合征
肌间静脉血栓形成	静脉血栓形成
特指胎盘疾病组织物残留	其他的胎盘疾患##胎盘部分残留不伴出血
继发性自身免疫性溶血状态	自身免疫性溶血性贫血
右前上纵隔类椭圆形囊性病变良性病变可能	纵隔囊肿
十二指肠T细胞淋巴肿瘤	肠淋巴瘤##T-细胞淋巴瘤
结肠管状-绒毛状腺瘤	结肠良性肿瘤##管状绒毛状腺瘤
晚孕单肾	妊娠状态
特发性脊椎侧凸	脊柱侧弯
先天性阴囊重度畸形	睾丸和阴囊的其他先天性畸形
右侧提肩胛肌腱炎	肌腱炎
血管免疫母细胞性T细胞淋巴瘤	血管免疫母细胞T细胞淋巴瘤
类风湿性关节炎间质性肺炎	类风湿性肺病
右耳中重度混合型聋左耳中重度传导性聋	单侧传导性聋##单侧混合性聋
左侧混合型FAI继发盂唇撕裂	髋关节撞击综合征##髋部损伤
冠心病(陈旧心梗)	陈旧性心肌梗死##冠状动脉粥样硬化性心脏病
颈部多间隙感染	感染
卵巢子宫内膜样腺CA	卵巢恶性肿瘤##子宫内膜样腺癌
升结肠息肉	结肠息肉
肠系膜血管炎	血管炎[脉管炎]
"子宫内膜腺癌IB期G1-2术后放疗,白细胞减少,肝功异常,抑郁症,高血脂，行动不便"	子宫内膜恶性肿瘤##腺癌##恶性肿瘤术后放疗##白细胞减少##肝功能异常##高脂血症##抑郁症
左肺曲霉球病	肺曲霉菌病
骶部脊椎裂	骶段脊柱裂
晚期胃腺癌	胃恶性肿瘤##腺癌
鼻窦部乳头状瘤	鼻窦良性肿瘤##鼻窦部乳头状瘤
骶尾部表皮囊肿	表皮囊肿
粘膜白斑	"白斑病,不可归类在他处者"
胃窦低级别腺管状腺瘤未累及切面	胃良性肿瘤##管状腺瘤
癫痫病灶切除术后	癫痫##脑术后
左眼睑皮肤裂伤	眼睑裂伤
股外侧皮神经病	身体未特指部位的神经损伤
智力语言发育差原因待查	言语和语言发育障碍
腹盆腔淋巴结继发恶性肿瘤	腹腔淋巴结继发恶性肿瘤##腹腔淋巴结继发恶性肿瘤
右肱骨外科颈骨折伴大结节撕脱	肱骨外科颈骨折##肱骨大结节骨折
错构瘤	错构瘤
口底癌	口底恶性肿瘤##癌
右乳良性导管扩张左乳良性导管扩张	乳腺导管扩张症
膝OA腰OA	膝骨关节病##腰椎退行性病变
口腔癌	口腔恶性肿瘤##癌
鼻咽非角化鳞癌	鼻咽恶性肿瘤##鳞状细胞癌
腰骶部肌肉拉伤脂肪疝	下背肌肉损伤##脂肪疝
双侧踇趾甲下黑斑甲下淤血	色素沉着未特指的疾患
腰4-5椎间盘突出症	腰椎间盘突出
左上肢软组织劳损	身体未特指部位的脱位、扭伤和劳损
右跟骨皮肤软组织缺血坏死	足坏死
口腔左舌覆扁平苔藓伴轻糜免疫异常	口腔扁平苔癣##舌扁平苔癣
前列腺增大伴小囊肿	前列腺增生##前列腺囊肿
左足拇趾趾甲剥脱甲床破裂	甲脱离
左眼永存原始玻璃体增生症	永存原始玻璃体增生症
章鱼罐综合症	应激性心肌病[心尖球形综合征]
左手指皮肤肿物	皮肤肿物
右小腿截肢术后骨外露并感染	截肢
疖肿病(臀部)	疖肿病
胸闷、发慌	胸闷##心悸
化扁；溃疡性口腔炎；支气管炎	急性化脓性扁桃体炎##溃疡性口炎##支气管炎
盆腔三维适形放疗后复发陀螺刀治疗后	放射治疗
四肢发僵原因－椎体外系疾患	肢体僵硬
特指贫血	其他特指的贫血
副乳腺腺病	副乳腺腺病
鼻窦继发癌	转移性癌##鼻窦继发恶性肿瘤
肝脾肿大酒肝	肝脾大##酒精性脂肪肝
双侧乳腺纤维腺瘤	乳腺良性肿瘤##纤维腺瘤
头面部广泛挫裂	头部损伤
左侧颈总动脉局部狭窄	颈总动脉狭窄
双肺结核性病变部分空洞形成	空洞型肺结核
肾功能不全;支气管炎;免疫缺陷病;冠心病	肾功能不全##支气管炎##免疫缺陷##冠状动脉粥样硬化性心脏病
化扁大肺	急性化脓性扁桃体炎
高甘油三酯脂血症前列腺梗阻未特指	前列腺未特指的疾患##高甘油三酯血症
左拇指掌指关节撕脱性骨折	拇指骨折##手部关节骨折
盆腔癌	盆腔恶性肿瘤##癌
急性粒细胞减少症	中性粒细胞减少症
输尿管结石体外碎石术后	输尿管结石##输尿管术后
眼部脉络膜黑色素瘤术后	脉络膜恶性肿瘤##黑色素瘤##眼术后
颈淋巴肿大大便干燥	其他大便异常##颈淋巴结肿大
隐匿性抑郁慢性主观性头昏	抑郁状态##头晕
食管中分化鳞形细胞癌	食管恶性肿瘤##鳞状细胞癌
肌酶增高查因肌酶增高查因肌酶增高查因	肌酸激酶增高
黄斑病变萎缩	视网膜病
眼轮匝肌麻痹痉挛	眼轮匝肌麻痹
手指脱位	指关节脱位
回肠造口术状态	回肠造口状态
右眼高眼压右眼球结膜淋巴循环障碍	高眼压症##淋巴回流障碍
自身免疫性溶血性疾病(冷型)	自身免疫性溶血性贫血(冷型)
原发性肝癌;慢性乙型病毒性肝炎;肝炎后肝硬变;骨转移	肝恶性肿瘤##癌##慢性乙型病毒性肝炎##肝炎肝硬化##骨继发恶性肿瘤##转移性癌
胰腺中分化腺癌IV期	胰腺恶性肿瘤##腺癌
心膈角区淋巴结继发恶性肿瘤	淋巴结继发恶性肿瘤
孕1产0孕33W+胎膜早破	孕33周##胎膜早破
多发颅内动脉狭窄伴不稳定斑块	动脉狭窄
颅内癌	颅内恶性肿瘤##癌
脑卒中高血压高脂血症	脑卒中##高血压##高脂血症
缺锌和缺铁明显	铁缺乏##锌缺乏
左手裂伤感染?	手部损伤##手感染
骶尾部囊肿	骨盆部囊肿
双眼倒睫术后	倒睫##眼术后
糖皮质激素诱导性骨质疏松症	骨质疏松##激素药物反应
足部软组织损伤伴感染	足部损伤##足软组织感染
左膝股骨内髁骨转换异常左膝OA	单侧膝关节骨性关节病##代谢性骨病
肺间质纤维化(炎症后);冠心病心律失常型;高脂血症;脑血栓形成;感冒	炎症后肺间质纤维化##冠心病心律失常型##高脂血症##脑血栓形成##感冒
左肩胸部梭形细胞瘤	胸部肿瘤##肩部肿瘤
纵膈肺门占位	胸腔占位性病变##肺占位性病变
左大腿皮肤人咬伤	下肢开放性损伤
脊髓灰质炎治疗后	急性脊髓灰质炎
周期性麻辟低钾	低钾型周期性瘫痪[低血钾性周期性麻痹/家族性周期性瘫痪]
右膝部皮肤错裂伤	下肢撕裂伤
胎儿异常双胎之一右锁骨下动脉迷走可能	迷走锁骨下动脉畸形
左踝关节多发性游离骨块距骨囊性变	踝关节内游离体##距骨骨囊肿
全心功能减弱	全心衰竭
肋软骨瘤可能	肋骨良性肿瘤##软骨瘤
死胎3胎盘胎膜残留	部分胎盘和胎膜滞留不伴有出血##胎死宫内
西医1神经症2脑后循环缺血	后循环缺血##未特指的神经症性障碍
结肠管状腺瘤直肠绒毛-管状腺瘤	结肠良性肿瘤##管状腺瘤
增生期样子宫内膜伴息肉	子宫内膜增生##子宫息肉
椎体破坏伴不全瘫	不完全性瘫痪##骨质破坏
右冠心肌桥	冠状动脉肌桥
停经152周B超提示胎儿巨大膀胱	妊娠状态
双腿肿痛	下肢肿胀##下肢疼痛
右髋关节股内侧肌肌肉拉伤	髋和大腿多处肌肉和肌腱损伤
急性移植物抗宿主反应病皮肤胃肠道	急性移植物抗宿主病
头面部跌伤	头部损伤##摔伤##面部损伤
右下肢皮肤色素沉着伴皮肤破溃	皮肤色素沉着##下肢开放性损伤
心脏病神经紊乱型	心脏神经症
腺瘤甲状腺	甲状腺良性肿瘤##腺瘤
右前臂带状孢疹	带状疱疹
右上肺腺癌 PT2N0M0 IB期 PS:1	右肺上叶恶性肿瘤##腺癌
面头皮疹颈淋巴肿大	皮疹##颈淋巴结肿大
高甘油三酯脂血症心脏病未特指	高甘油三酯血症##未特指的心脏病
右眼眶炎性	未特指的眼眶疾患
哮喘，慢支，肺气肿;肺部感染，动脉硬化;	支气管哮喘##慢性支气管炎##肺气肿##肺部感染##动脉硬化
左枕部皮肤划伤	头皮开放性损伤
卵巢癌术后复发，腹腔转移	卵巢术后##卵巢恶性肿瘤##腹腔继发恶性肿瘤##癌##转移性癌##恶性肿瘤复发
十二指肠恶性肿瘤术后(恶性黑色素瘤)	十二指肠恶性肿瘤##十二指肠术后##恶性黑色素瘤
左颈胸部占位性病变	颈部占位##胸部占位
原发性甲状旁腺亢进症	原发性甲状旁腺功能亢进
胃角早期胃癌	胃恶性肿瘤##癌
右肱骨外侧髁陈旧性撕脱性骨折	肱骨外髁骨折##陈旧性肱骨骨折
轻度脑功能异常	中枢神经系统未特指的疾患
重度骨质疏松(伴骨痛)	重度骨质疏松##骨痛
双膝关节髌内侧滑膜皱襞综合症	膝关节滑膜皱襞综合征
右乳腺非特殊型浸润性癌	乳腺恶性肿瘤##癌
右侧额窦骨瘤	鼻窦良性肿瘤##骨瘤
手指麻木原因待查多发性周围神经病可能性大	多发性神经病[多发性神经炎/周围神经炎]
左舌颌下腺囊肿	下颌下腺囊肿##舌下腺囊肿
创伤性脊椎病坎梅耳氏病	创伤后脊椎病##kummell病
右侧平足右胫骨远端骨质改变	扁平足
溃疡病腹痛待查	消化性溃疡##腹痛
冠心病高血压病高脂血症	冠状动脉粥样硬化性心脏病##高血压##高脂血症
乙状结肠癌腹主动脉旁、左髂总血管旁淋巴结转移	乙状结肠恶性肿瘤##癌##淋巴结继发恶性肿瘤
宫颈中分化鳞状细胞癌IB1期	子宫颈恶性肿瘤##鳞状细胞癌
右乳癌术后锁骨上淋巴结转移	乳腺术后##乳腺恶性肿瘤##癌##锁骨上淋巴结继发恶性肿瘤
左小腿皮肤软组织撕脱伴潜行剥离	下肢撕脱伤
耵聍嵌塞	外耳道耵聍栓塞
食管中段癌放化疗后	食管中三分之一的恶性肿瘤##癌##恶性肿瘤放疗
右尺桡骨粉碎性骨折	尺骨骨折##桡骨骨折
弥漫大B细胞淋巴瘤复发	弥漫大B细胞淋巴瘤##恶性肿瘤复发
富于T的B细胞淋巴瘤	富T细胞/富组织细胞大B细胞淋巴瘤
妊娠40周，孕1产0，LOP，单活胎	孕40周
血管性认知功能减退	血管性认知功能障碍
交叉韧带肿胀	膝关节十字韧带损伤
右腰5骶1神经根病变	腰骶神经根损害
结肠肝曲管状腺瘤直肠管状腺瘤	结肠肝曲良性肿瘤##直肠良性肿瘤##管状腺瘤
肢体肿胀(静脉曲张)	肢体肿胀##静脉曲张
胃多发息肉病	胃息肉
四肢无力原因待查格林巴利综合征待除外	吉兰-巴雷综合征##肢体无力
送检瘘管内衬复层鳞状上皮符合腮裂瘘管改变	鳃裂瘘
孤立性ACTH缺乏继发肾上腺皮质机能减退	孤立性ACTH缺乏症(IAD)
左半结肠中低化腺癌PT4AN0MXⅡB期	结肠恶性肿瘤##腺癌
宫颈子宫内膜样腺癌	子宫内膜恶性肿瘤##腺癌
腮腺裂伤	口腔和咽喉部损伤
第一二腮综合症	第一、二鳃弓综合征[Goldenhar综合征]
放射性口腔炎	口炎##放射性损害
精神发育不良	精神发育迟滞
疑右臀上皮下血肿机化	血肿机化
婴儿支气管炎	支气管炎
G3P1孕40+2周宫内妊娠剖宫产LOT	无指征剖宫产的单胎分娩
额叶多发脑腔隙灶伴缺血	脑血管供血不足##腔隙性脑梗死
颅内多发轻度动脉狭窄伴斑块形成	动脉狭窄
惊厥(？)	其他和未特指的惊厥
右肺中叶鳞癌维持性化学治疗	右肺中叶恶性肿瘤##鳞状细胞癌##恶性肿瘤维持性化学治疗
右足踇趾甲床破裂趾甲剥脱	甲脱离
食管胃结合部腺癌	食管胃连接部恶性肿瘤##腺癌
右肺尖神经肿瘤，支气管炎	肺占位性病变##神经瘤##支气管炎
宫颈II级	宫颈上皮瘤样病变[CIN]II级
右手中环指软组织缺损伴骨外露坏死	手坏死
人工晶体植入右眼	人工晶体植入状态
右侧肋间血管破裂	血管断裂
左肾高密度影结合临床除外高密度囊肿	泌尿器官诊断性影像检查的异常所见
埋伏牙和阻生牙	埋伏牙##阻生牙
交通性脑积水外伤性精神障碍	交通性脑积水##精神障碍
肺癌可能大	肺恶性肿瘤##癌
动脉导管未关闭	动脉导管未闭
产后出血，中度失血性贫血，妊娠期血小板减少症，妊娠期高血压疾病，妊娠9+月孕2产1剖宫产术后	产后出血##失血性贫血##妊娠合并血小板减少##妊娠期高血压##经未特指的剖宫产术分娩
乳房纤维瘤	乳腺纤维瘤
左迷走神经鞘膜瘤	迷走神经良性肿瘤##神经鞘膜瘤
宫颈中分化腺癌IIB期术后2程化疗后	子宫颈恶性肿瘤##腺癌##恶性肿瘤术后化疗
原发腹膜癌	腹膜恶性肿瘤##癌
升结肠癌并不全性肠梗阻	升结肠恶性肿瘤##不完全性肠梗阻##癌
"盆腔肿物,怀疑直肠癌"	盆腔肿物##直肠恶性肿瘤##癌
导管内乳头状瘤右乳	乳腺良性肿瘤##导管内乳头状瘤
子宫偏小PCOS	多囊卵巢综合征[Stein-Leventhal综合征]
左大腿肌肉扭伤	下肢肌肉损伤
大肠和小肠克罗恩病脓肿[节段性肠炎]	大肠克罗恩病##小肠克罗恩病
胸壁皮肤受侵	胸壁继发恶性肿瘤
右拇指末节骨骺肥大伴指间关节先天性融合	指融合
右锁骨考虑Sweet病	急性发热性嗜中性皮病
右肾积水伴肾功能不全	肾积水##肾功能不全
C2-3棘突融合	脊柱的其他融合
腰椎间盘膨出继发神经损害	腰椎间盘移位##腰骶神经损伤
左乳切除后，右乳肿块（脂肪瘤？）	乳房肿物##乳房脂肪瘤
高血压性肾脏病伴有慢性肾衰竭	高血压性肾病##慢性肾衰竭
1高癌胚抗原血症	CEA升高
副乳腺	副乳
截瘫(待查)	未特指的截瘫
停经392周MR提示胎儿后颅窝池扩张	妊娠状态
"左腭CA手术后,术后放疗化疗"	腭恶性肿瘤##恶性肿瘤术后化疗##恶性肿瘤术后放疗##癌
胆总管癌	胆总管恶性肿瘤##癌
左膝前十字韧带损伤	膝关节前十字韧带损伤
子宫肌瘤病	子宫平滑肌瘤
子宫内节育器移位(下移)	避孕环移位
肢体无力原因格林巴利综合征	肢体无力##吉兰-巴雷综合征
喉部分切除术气管切开术	喉术后
胸腰椎骨折	胸椎骨折##腰椎骨折
胸101112椎骨质破坏待查伴不全瘫	不完全性瘫痪##骨质破坏
慢性GVHD肝脏皮肤广泛型	慢性移植物抗宿主病
左面神经疾患左面神经功能亢进	未特指的面神经疾患##面神经功能障碍
左足背部分皮肤改变坏死	足坏死
左颈内动脉起始段内膜病变伴局限狭窄	颈内动脉狭窄
肝内胆汁淤积综合症	胆汁淤积症
宫颈原位腺癌	子宫颈恶性肿瘤##原位腺癌
肌萎缩原因待查脊髓前角受累可能性大	肌肉萎缩##脊髓前角病变
骶尾部皮肤II°灼伤	"躯干未特指的损伤,水平未特指"
腹腔广泛种植转移	腹腔继发恶性肿瘤##广泛转移性肿瘤
心肌桥前降支肌桥收缩期狭窄约85	冠状动脉肌桥##冠状动脉狭窄
右侧甲状腺滤泡型腺瘤	甲状腺良性肿瘤##滤泡性腺瘤
腰2椎体压缩性性骨折伴截瘫	腰椎压缩性骨折##截瘫[双下肢瘫痪]
停经232周B超提示胎儿骶尾部混合回声	妊娠状态
肾造瘘术后(左)	肾造口状态
中度混合性听力下降	未特指的混合性传导性和感音神经性听觉丧失
特指单个手指部分或完全切断左手示指缺如	其他单个手指创伤性切断(完全)(部分)##创伤性手指缺如
肺曲霉病(拟诊)	肺曲霉菌病
支气管粘膜色素沉着纤维化症	碳末石末沉着病[煤矽肺]
手足发育异常	先天性手畸形##先天性足畸形
右肺中叶碳末沉着病炭肺	碳末沉着病[炭肺]
咽炎扁桃体炎鼻炎	扁桃体炎##咽炎##鼻炎
郁症.失眠.腰腿痛.甲状腺结节	失眠##腰痛##下肢疼痛
双肺多发性囊性支扩肺心衰	心力衰竭##支气管扩张症
特指大便异常直肠病变	其他大便异常##肠未特指的疾病
左大腿左小腿割伤	大腿开放性损伤##小腿开放性损伤
左颌颈部肉芽肿性炎	肉芽肿
联合性免疫缺乏症	联合免疫缺陷病
右乳纤维腺瘤伴钙化	乳腺良性肿瘤##纤维腺瘤
病脑视幻	病毒性脑炎##幻视
气管切口出血	操作后切口出血
先天性聋哑症	先天性聋##聋哑症
食道小细胞癌	食管恶性肿瘤##小细胞癌
左面部麻木味觉减退功能性可能性大	味觉障碍
黄斑裂孔术后	黄斑裂孔
双肺纹理增粗左下肺纤维索条病变	肺诊断性影像异常
门静脉海绵状变性	门静脉海绵样变
L5-S1区异常高密度影性质待查	其他特指身体结构诊断性影像检查的异常所见
胸中下段食管癌伴纵隔、左颈多发淋巴结转移	食管胸中段恶性肿瘤##食管胸下段恶性肿瘤##癌##颈部淋巴结继发恶性肿瘤##纵隔淋巴结继发恶性肿瘤
头颈部多处抓伤	头部多处损伤##颈部多处损伤
肺真菌感染重症	肺真菌感染
影像诊断原发性肝晚期家属取药	肝恶性肿瘤
头痛;急性胃黏膜病变	头痛
右环指伸肌腱中央腱止点撕脱性骨折	指骨骨折
鞍区结核瘤	结核感染
心脏起搏器安装术后	具有心脏起搏器状态
牙周炎A67牙本质过敏C2-D1楔缺	牙本质过敏症##牙齿楔状缺损##牙周炎
双卵巢高级别乳头状腺癌	卵巢恶性肿瘤##乳头状腺癌
多形红斑性药物疹	药物性红斑
胸憋浮肿下肢静脉功能异常	水肿##下肢静脉功能不全
肌肉肿物NOS(右上臂肿物)	肌肉肿物##上肢肿物
十二指肠球部癌	十二指肠恶性肿瘤##癌
桥臂脱髓鞘改变	脱髓鞘性脑病
肾上腺神经节母细胞瘤术后复发（IV期）	肾上腺恶性肿瘤##神经节神经母细胞瘤##恶性肿瘤复发
右足，左小腿骨折复查	"足骨折,未特指##小腿骨折"
Graves病合并桥本甲状腺炎	弥漫性甲状腺肿伴甲状腺功能亢进[Graves病]##自身免疫性甲状腺炎[桥本病]
头面部多处开放性损伤	头部多处开放性损伤##面部开放性损伤
癫痫灶切除术后	癫痫##脑术后
右侧海马硬化	脑其他特指的疾患
心脏左室松弛减退部分心肌缺血性改变	心肌供血不足
矮身材除外克丁病	身材矮小症
巧囊术后	卵巢巧克力样囊肿##卵巢术后
左侧腋窝包块原因脂肪沉积	腋窝占位
CAD血压病	高血压
宫颈角化型鳞状细胞癌	子宫颈恶性肿瘤##鳞状细胞癌
慢性肾功不全尿毒症期CKD5期	"慢性肾脏病,5期"
狼疮足细胞病	"系统性红斑狼疮,累及器官或系统"
左小腿筋膜间室综合症	下肢骨筋膜室综合征
肩背部软组织劳损	肩颈部劳损##背部劳损
T淋巴母细胞淋巴瘤 IV期	T淋巴母细胞白血病/淋巴瘤
感染性疾病脑梗后低血糖	感染##脑梗死##低血糖症
右膝关节皮肤软组织损伤	膝关节损伤
脾脏肿大脾功亢进	脾功能亢进##脾大
绒癌化疗后	绒毛膜癌##化学治疗
右上腹不适待查，消化不良？	消化不良
双胎之一羊水增多胎儿肠管扩张	双胎妊娠##妊娠合并羊水过多
停经24周B超提示胎儿左侧胸腔内混合回声	孕24周
双肺部分慢性炎症，部分炎性肉芽肿形成可能	肺炎##肺肉芽肿
胎盘疾病胎盘低置状态	其他的胎盘疾患##低置胎盘
食管下段鳞状细胞癌	食管下三分之一的恶性肿瘤##鳞状细胞癌
停经22周院外B超提示左肾未显示	孕22周
管状静脉窦无顶综合征	无顶冠状静脉窦综合征
腰腿痛骨关节病骨质疏松	腰痛##下肢疼痛##骨关节病##骨质疏松
全身多处转移	多部位继发恶性肿瘤##转移性肿瘤
腰34椎间盘彭出症	颈椎间盘脱出
肺肾阴虚，冠心病	冠状动脉粥样硬化性心脏病
类风湿性关节炎疼痛	类风湿性关节炎##关节痛
麻木无力待查脊髓病可能性大	脊髓病##肌无力
双耳听力障碍	听功能障碍
右乳纤维囊性乳腺病伴钙化	乳房纤维囊性乳腺病##乳腺钙化
肋骨胸腰椎多发性占位	胸部占位##脊柱占位
左膝骨关节病	单侧膝关节骨性关节病
颈胸腰椎间盘退行性变	颈椎退行性病变##胸椎退行性病变##腰椎退行性病变
右下肢静脉栓塞和血栓形成	下肢静脉血栓形成##静脉栓塞
子宫内膜透明细胞癌Ia期	子宫内膜恶性肿瘤##透明细胞癌
乳腺动态未定肿瘤新D48600	乳房动态未定或动态未知的肿瘤
右肺上叶支气管新生物性质待查炎性病灶	支气管息肉##支气管炎
子宫卵巢发育不良	特纳综合征[Turner综合征]
直肠管状腺瘤少许腺体中度异型增生	直肠良性肿瘤##管状腺瘤
颈髓病变脊髓亚急性联合变性可能性大	亚急性脊髓联合变性病##脊髓病
双眼闭角型青光眼（右眼抗青术后，左眼临床前期）	闭角型青光眼##眼术后
乳腺术后放化疗后	乳腺术后##化学治疗##放射治疗
左足距下关节骨不连	距骨骨折不连接
急性脑梗塞陈旧性脑干梗塞	脑梗死##陈旧性脑梗死##脑干梗死
1大肺2维生素AD缺乏	维生素A缺乏##维生素D缺乏
肝、脾、双肺转移	肝继发恶性肿瘤##脾继发恶性肿瘤##肺继发恶性肿瘤##转移性肿瘤
结肠癌晚期	结肠恶性肿瘤##癌
二度房室阻滞	二度房室传导阻滞
横结肠结肠管状腺瘤低级别	管状腺瘤##横结肠良性肿瘤
左膝退变伴游离体	膝骨关节病##膝关节游离体
慢性肾功能不全冠状动脉粥样硬化性心	慢性肾功能不全##冠状动脉粥样硬化性心脏病
单心室（心脾综合症）	单心室
结肠蕈伞型中分化腺癌	结肠恶性肿瘤##腺癌
右乳腺纤维瘤切除术后	乳腺术后##乳腺纤维瘤
右下肢肌肉萎缩	下肢肌肉萎缩
脑梗塞，CDH	脑梗死##先天性髋关节脱位
颈部、腰部外伤	颈部损伤
结肠低分化腺癌根治术后pT4NxMx	结肠恶性肿瘤##腺癌##结肠术后
扩张性心脏病心功能Ⅲ-Ⅳ级	心功能III级(NYHA分级)##心功能IV级(NYHA分级)##扩张性心肌病[充血性心肌病]
预防措施其他特指的放疗脑	放射治疗
心搏骤停	心脏停搏
左小脑半球血管网状细胞病	烟雾病[脑底异常血管网病]
宫颈CIN2绝经后期	宫颈上皮瘤样病变[CIN]II级##绝经期
发作性双下肢无力待查胸髓病变待除外	肢体无力##脊髓病
认知功能缺损	认知障碍
腹腔炎性肿块	腹腔内和盆腔的肿胀、肿物和肿块
双下肢神经病变	多发性神经病[多发性神经炎/周围神经炎]
右乳乳腺癌	乳腺恶性肿瘤##癌
双侧颈内动脉动脉瘤	颈内动脉瘤
盆骨肿瘤，恶性	盆骨恶性肿瘤
阴道斜隔	阴道斜隔
肺部阴影(感染性)	肺部阴影##肺部感染
乳腺癌手术	乳腺恶性肿瘤##乳腺术后##癌
盆底功能障碍性疾病阴道前壁膨出Ⅱ期	阴道脱垂##盆底功能障碍
左胫骨假关节	骨折不连接[假关节]
淋巴结窦组织细胞增多症	窦组织细胞增多伴巨大淋巴结病[Rosai-Dorfman病]
原发不孕单角子宫	原发不孕##单角子宫
糖尿病足截趾术后	糖尿病足##截肢
全身多处火焰烧伤	火焰烧伤##多处烧伤
门静脉及下腔静脉、左心房内癌栓。	门静脉瘤栓##腔静脉瘤栓
双卵巢高级别浆液性腺癌	卵巢恶性肿瘤##浆液性腺癌
突眼	眼球突出
白细胞粒细胞减少症	白细胞减少##中性粒细胞减少症
肠积气十二指肠内积气腹腔内肠管积气	肠胀气
结肠肝曲癌并不全梗阻	结肠肝曲恶性肿瘤##不完全性肠梗阻##癌
胸段病变伴不全滩	不完全性瘫痪
出血性脑梗死后遗症继发癫痫发作	出血性脑梗死##脑梗死后遗症##症状性癫痫[继发性癫痫]
左肺中心型低分化鳞癌（T4N2M0）III期	左肺恶性肿瘤##鳞状细胞癌##淋巴结继发恶性肿瘤
高位颈髓椎管内占位	椎管占位
多发颅颈椎动脉狭窄伴斑块狭窄	椎动脉狭窄##椎动脉斑块
膜性肾小球肾病	膜性肾病
高血压;A族高脂血症;心绞痛;支架植入术后状态;肺部感染	高血压##A族高脂血症##心绞痛##冠状动脉支架植入术后状态##肺部感染
真菌败血	真菌性败血症
左鳃裂瘘管	鳃裂瘘
胃食管反流伴喉咽反流	胃食管反流##喉咽反流
左小腿大隐静脉轻度曲张	大隐静脉曲张
局灶增生性IGA肾病伴部分新月体形成	新月体性IgA肾病
急性咽喉炎;咳嗽;慢性鼻咽炎;过敏性鼻炎(变应性鼻炎);变应性哮喘	急性咽喉炎##咳嗽##慢性鼻咽炎##过敏性鼻炎[变应性鼻炎]##主要为变应性哮喘
右输尿管上段结石并右肾重度积水	肾积水伴输尿管结石
腰骶外伤骶4椎体骨折	骶骨骨折##骨盆部损伤
染色体平衡移位t'13	未特指的染色体异常
2型糖尿病并心脏损害	2型糖尿病
妊娠32周5/4宫内死胎	孕32周##胎死宫内
脑内出血后遗症	脑出血后遗症
腰45椎间盘膨出骶管小囊肿	腰椎间盘移位##椎管囊肿
粒细胞减少症 复诊	中性粒细胞减少症
肠激惹综合征	肠易激综合征
左肾旋转不良伴缺血性改变	先天性肾旋转不良
胸椎脊柱旁占位	脊柱占位
咳嗽、发热原因待查：肺部感染？肺部结核？肺部肿瘤？	咳嗽##发热##肺部感染##肺结核##O
小肠血管畸形可能	小肠血管畸形
良性分叶状肿瘤	良性叶状瘤
左骨盆骨肉瘤复发术后(ENNEKING分期 III期)	骨盆恶性肿瘤##骨肉瘤##盆腔术后##恶性肿瘤复发
多发性梗塞累及脑干	多发性脑梗死##脑干梗死
颈腰椎间盘多发膨出	其他特指的椎间盘移位##腰椎间盘移位
腰4/5椎间盘突出症	腰椎间盘突出
内耳耳石症	良性阵发性位置性眩晕
左中指及环指皮肤缺失伴坏死	后天性单侧手指缺失##手坏死
局造灶性高级别鳞状上皮内病变LEEP治疗	宫颈术后
胎儿2部分型肺静脉异位引流	部分型肺静脉异位引流
肥胖症	肥胖
左侧颞顶部颅内异常信号影	"颅骨和头诊断性影像检查的异常所见,不可归类在他处者"
膝滑膜皱襞综合征	膝关节滑膜皱襞综合征
对角支粥样硬化伴中-重度狭窄	冠状动脉粥样硬化##冠状动脉狭窄
"35、45牙本质过敏,17、47创伤性根周膜炎,14牙体楔状缺损"	牙本质过敏症##牙齿楔状缺损##牙及相关组织损伤
双侧髂前上脊褥疮双下肢褥疮	压疮
面部多处软组织切割伤	面部损伤##多处切割伤
右肺纤维硬结灶右肺肥大泡	肺诊断性影像异常##肺大疱
骶尾骨中部骨折	骶骨骨折
颈部恶性神经鞘瘤术后	颈部恶性肿瘤##恶性神经鞘瘤
"胃体神经内分泌癌,肝转移"	胃体恶性肿瘤##神经内分泌癌##肝继发恶性肿瘤##转移性神经内分泌癌
颅内病变性质待查脱髓鞘疾病可能性大	脱髓鞘病
左肺上叶小细胞癌局限期 cT3N3M0 IIIc期	左肺上叶恶性肿瘤##小细胞癌##淋巴结继发恶性肿瘤
左中指远节指骨粗隆内侧缘撕脱性骨折	指骨远节骨折
壶腹腺癌	法特壶腹恶性肿瘤##腺癌
肿瘤标志物升高总PSA升高	PSA升高##肿瘤标记物升高
双侧慢性鼻窦炎鼻息肉	鼻息肉##慢性鼻窦炎
垂体发育不全	垂体发育不良
A345B1234楔状缺损C7龋齿	牙齿楔状缺损##龋病
"面部包块,[皮炎"	面部肿物##皮炎
甲状旁腺机能亢进(甲状旁腺腺瘤)	甲状旁腺功能亢进##甲状旁腺良性肿瘤##腺瘤
腰椎病左侧神经根受压	腰椎病
肾上腺继发癌	肾上腺继发恶性肿瘤##转移性癌
胃弥漫大B细胞型生发中心B细胞来源	胃恶性肿瘤##弥漫大B细胞淋巴瘤
左眼人工晶体植入状态后囊混浊	人工晶体植入状态
左眼角膜中央板层戳伤	角膜损伤
右前颅底改变符合骨纤维结构不良	颅骨纤维增殖症
左中环小指掌侧皮肤挛缩伴功能障碍	瘢痕挛缩
下咽部差分化腺癌	咽恶性肿瘤##腺癌
热液烫伤40%二度2%三度38%右上肢腰	上肢烫伤##躯干部烫伤
上腔静脉阻塞综合症	上腔静脉阻塞综合征
嗜酸细胞性肉芽肿	嗜酸性肉芽肿
颈34融合颈45不稳脊柱轻度侧弯	先天性颈椎体融合##颈椎不稳定##脊柱侧弯
胰腺尾部CA化疗后	胰尾恶性肿瘤##癌##化学治疗
急性心功能不全	心功能不全
双肺间质改变左上肺斑片影可疑	肺部阴影
无月经待诊多囊卵巢综合症	闭经##多囊卵巢综合征[Stein-Leventhal综合征]
局部包块待查：淋巴管瘤？	淋巴管瘤##淋巴管瘤
骶尾椎病变马尾神经受压	脊髓受压
抗心磷脂抗体综合症	抗心磷脂抗体综合征
右小腿皮肤擦挫伤	小腿挫伤##小腿擦伤
肛瘘（高位？）	高位肛瘘
左眼睑挫裂伤	眼睑裂伤##眼睑挫伤
急性胆囊炎胆囊结石;肠梗阻;	急性胆囊炎##胆囊结石##肠梗阻
颈2椎体及左横突粉粹性骨折	颈椎骨折
L5压缩性骨折	腰椎骨折L5##腰椎压缩性骨折
右手麻木待查-右肘尺管综合症	肘管综合征
左上腹胸壁疼痛待查	上腹痛##前胸壁痛
失代偿性呼吸性酸中毒并代谢性碱中毒	呼吸性酸中毒##代谢性碱中毒
双侧卵巢交界性浆液性囊腺瘤IIIc期	卵巢交界性肿瘤##浆液性囊腺瘤
肛周湿疣术后	肛门生殖器疣
宫颈鳞状上皮内高度病变CIN-Ⅲ累及腺体	子宫颈上皮内瘤变III级[CINIII级]
停经123周B超提示胎儿脐部异常回声	妊娠状态
语言智力发育迟缓原因待查	言语和语言发育障碍##发育迟滞
坐骨神经麻痹	坐骨神经损害
右侧后腹膜神经母细胞瘤化疗后	神经母细胞瘤##腹膜恶性肿瘤##化学治疗
"上呼吸道感染、发热、咳嗽咽痛,行动不便,感冒，胃溃疡,慢性便秘,过敏,慢性咽炎"	上呼吸道感染##发热##咳嗽##咽痛##感冒##胃溃疡##便秘##过敏反应##慢性咽炎
肺周围型腺癌	肺恶性肿瘤##腺癌
"早孕,腹痛"	妊娠状态##腹痛
面部麻木原因待明神经症可能	神经症性障碍
左上睑外伤后疤痕左上睑闭眼功能不全	影响眼睑功能的其他疾患
双眼闭角型青光眼（虹膜激光周切术后）	闭角型青光眼##眼术后
嗜酸细胞性结肠炎	嗜酸细胞性胃肠炎
狂犬疫苗后急性播散性脊髓膜炎	疫苗接种后脑脊髓炎##急性播散性脑脊髓炎
双侧硬膜下慢性硬膜下血肿	硬膜下血肿
胃癌?胃镜检查，预防出血	胃恶性肿瘤##癌
停经293周B超提示胎儿上牙槽排列紊乱	妊娠状态
新生儿应激性溃疡	新生儿消化性溃疡
右肾细胞Ca	肾恶性肿瘤##肾细胞癌
胃低分化腺癌伴印戒细胞癌	胃恶性肿瘤##腺癌##印戒细胞癌
右侧颞叶异常信号考虑梗塞可能性大	脑梗死
高血压性心脏心脏增大心功能III-IV级	心功能III级(NYHA分级)##心功能IV级(NYHA分级)##慢性心力衰竭
肢体麻木原因待查1脑血管疾病2颈腰椎病	腰椎病
双下肢跛行待查小平足	扁平足
右股骨中下段骨折	股骨骨折
避孕问题，女扎术后	避孕问题##结扎输卵管绝育
右肺腺癌的支持治疗	右肺恶性肿瘤##腺癌
冠心病高血压病腰腿痛脑血栓	冠状动脉粥样硬化性心脏病##高血压##脑血栓形成##腰痛##下肢疼痛
淋巴瘤复发	淋巴瘤##恶性肿瘤复发
慢性浅表性胃炎伴胆汁反流	慢性浅表性胃炎##胆汁反流
胆肠吻合状态	肠吻合状态
膝关节骨关节炎左膝游离体	单侧膝关节骨性关节病##膝关节游离体
慢性泪囊炎术后	慢性泪囊炎##眼术后
多发子宫肌瘤	子宫多发性平滑肌瘤
腹腔淋巴结继发癌	腹腔淋巴结继发恶性肿瘤##癌
双侧髋关节发育性全脱	先天性双侧髋关节脱位
胎儿脐血偏高	脐血流比值高
左下肢体无力查因	肢体无力
双侧先天性膑骨关节脱位	髌骨脱位
右下肢动脉支架植入术及球囊扩张术	血管支架植入术后状态
"龋,溃疡"	龋病
子宫内膜低中分化腺癌	子宫内膜恶性肿瘤##腺癌
宫颈鳞状细胞CaIIa1期	子宫颈恶性肿瘤##鳞状细胞癌
右侧颈部皮肤肿物	颈部肿物
真菌性肺炎肺组织胞浆菌病	真菌性肺炎##组织胞浆菌病
良性前列腺组织伴间质慢性炎	慢性前列腺炎
慢性胃炎伴糜烂.失眠	慢性胃炎##糜烂性胃炎##失眠
重度骨关节炎(腘窝囊肿)	腘窝囊肿##重度骨关节病
颈脊髓空洞伴四肢不全瘫	不完全性瘫痪##脊髓空洞症
先天性被动免疫性血小板减少症	先天性血小板减少##免疫性血小板减少
左背部肋骨应力性损伤低钙	应力性骨折##肋骨骨折
右主支气管活检组织鳞形细胞癌中-低分化	右主支气管恶性肿瘤##鳞状细胞癌
左大腿开水烫伤	沸水烫伤##下肢烫伤
HIV相关性神经疾病	艾滋病[获得性免疫缺陷综合征]
右下肢血管畸型	下肢血管畸形
左眼ICE综合症	虹膜角膜内皮综合征[ICE综合征]
肝胆管细胞癌IV期	肝内胆管癌##肝胆管细胞癌
1、胸下段食管鳞癌;	食管胸下段恶性肿瘤##鳞状细胞癌
垂体功能障碍待排1器质性精神障碍	垂体功能低下##器质性精神障碍
特发性血小板减少性紫癜埃文斯综合征ITP	特发性血小板减少性紫癜
陈旧性腔隙性梗死	腔隙性脑梗死
臀部皮脂腺囊肿	皮脂腺囊肿
脑干出血，高血压病，冠心病	脑干出血##高血压##冠状动脉粥样硬化性心脏病
网膜转移	转移性肿瘤
考虑镍性皮炎日光性皮炎	镍变应性接触性皮炎##光照性皮炎
"胰腺癌术后,胃排空障碍,胰腺肿瘤,胰腺分泌功能不足,腹膜后肿大淋巴结,转氨酶升高"	胰腺术后##胰腺恶性肿瘤##癌##O##O##腹膜后淋巴结肿大##转氨酶升高
宫颈CIN2级阴道前后壁膨出	宫颈上皮瘤样病变[CIN]II级
腰4-55－骶1椎间盘突膨出	椎间盘突出
右手背及右腕部玻璃割伤	手部开放性损伤##腕部开放性损伤##玻璃割伤
肺心病心衰肺脑	肺源性心脏病##心力衰竭##肺性脑病
脑干脑炎后综合征	脑干脑炎
胸椎病变并不完全性截瘫	不完全性瘫痪##截瘫[双下肢瘫痪]
病理性椎体压缩骨折	病理性骨折##脊柱骨折
右踝距骨舟骨跖骨异常信号骨梗死可能	骨坏死
右踝及右膝OA	单侧膝关节骨性关节病##踝骨关节病
右手掌烫伤	手部烫伤
髋关节肌腱膜炎	肌腱炎
缺锌缺铁缺钙	铁缺乏##锌缺乏##钙代谢紊乱
急性下壁右室心肌再梗死KillipI级	急性下壁右心室再发心肌梗死##KillipI级
右膝前交叉韧带胫骨止点撕脱性骨折	胫骨骨折
主动脉返流	主动脉瓣关闭不全
左眼睑擦伤	眼睑和眼周区其他浅表损伤
急性髓细胞白血病M2型化疗后	急性粒细胞性白血病部分分化型(M2型)##化学治疗
"左乳腺癌术后肝Ｍ,化疗呕吐，化疗后WBC小于2000,化疗肝损伤,失眠"	乳腺术后##乳腺恶性肿瘤##肝继发恶性肿瘤##化学药物反应##呕吐##白细胞减少##肝损伤##失眠##癌
膀胱癌术后;肺气肿;慢性阻塞性肺病伴有急性加重	膀胱术后##膀胱恶性肿瘤##癌##肺气肿##慢性阻塞性肺疾病急性加重
支气管扩张;慢性阻塞性肺疾病;过敏性鼻炎(变应性鼻炎)	支气管扩张症##慢性阻塞性肺疾病##过敏性鼻炎[变应性鼻炎]
面瘫病	神经麻痹
MALT淋巴瘤	非霍奇金淋巴瘤(B细胞型)
右颈内静脉长期血透导管半脱出	透析导管引起的机械性并发症
右髂右腘静脉球囊扩张右髂静脉支架置入术	血管支架植入术后状态
膝关节骨性关节炎双侧严重性	双侧膝关节骨性关节病
特发性耳聋	特发性突聋
肺气肿并肺大泡形成	大疱性肺气肿
胆总管泥沙样结石伴下段轻度炎性狭窄	胆总管结石##胆总管狭窄
4、右胫骨中段骨折术后骨愈合	胫骨骨折##骨折术后
胸水查见癌细胞	恶性胸腔积液
右足第1－5跖趾关节囊破裂伴部分缺失	跖趾关节损伤
视网膜病(术后)	视网膜病##眼术后
右肾透明细胞性肾细胞癌	肾恶性肿瘤##透明细胞癌
双侧肾造瘘术后	肾造口状态
胃肠息肉病待排	胃息肉##肠息肉
左侧颈动脉岩段动脉夹层伴重度狭窄	颈动脉夹层##颈动脉狭窄
十二指肠球部溃疡合并梗阻	十二指肠球部溃疡##十二指肠梗阻
血脂高	高脂血症
结肠中-低分化腺癌	结肠恶性肿瘤##腺癌
黏多糖贮积症Ⅰ型双侧髋关节病理性脱	粘多糖贮积病I型[Hurler综合征]##髋关节脱位
强直-阵挛性癫痫	仅全面性强直-阵挛发作的癫痫
宫颈粘液性腺癌IB1期术后	子宫颈恶性肿瘤##粘液腺癌##子宫术后
其他诊断2宫颈肥厚	子宫颈肥大
下颌骨多发骨折	下颌骨骨折##面骨多发性骨折
大腿特指肌肉和肌腱损伤	在大腿水平的其他和未特指的肌肉和肌腱损伤
阴囊不适	不适
结肠癌晚期 肛周疼痛待查	结肠术后##结肠恶性肿瘤##癌##疼痛
右侧卵巢浆液性腺癌	卵巢恶性肿瘤##浆液性腺癌
右乳腺癌IV期	乳腺恶性肿瘤##癌
苍白球钙化	脑钙化
高血压脑动脉硬化所致	高血压
脑病待诊	脑病[器质性脑病]
动物咬伤	动物咬伤或造成损伤
宫颈炎特异阴道炎	子宫颈炎##阴道炎
脾形态符合淤血性脾肿大	脾大
小腿扭伤	下肢关节和韧带扭伤
成熟型畸胎瘤右卵巢	卵巢良性肿瘤##成熟型囊性畸胎瘤
功能(障碍)性子宫出血	功能性子宫出血
阴道胚胎性横纹肌肉瘤	阴道恶性肿瘤##胚胎型横纹肌肉瘤
双乳多发腺瘤	腺瘤##乳腺良性肿瘤
轻度“0”形腿消化功能差多汗缺锌	锌缺乏##多汗症
部分发作继发全身发作	癫痫部分性发作##癫痫大发作状态
"重度骨质疏松,有骨折史"	重度骨质疏松
脊柱退变形疾病	脊柱骨关节病
单纯性乳房发育缺锌缺铁取药	铁缺乏##锌缺乏
冠状动脉心肌桥累及前降支	冠状动脉肌桥
胃肠道交界性肿瘤	肠交界性肿瘤##胃交界性肿瘤
左足开水烫伤	沸水烫伤##足部烫伤
右侧颌下淋巴结Castleman病	Castleman病
左眼球挫裂伤	眼球挫伤##眼球破裂伤
内膜异位肌腺症	子宫内膜异位##子宫肌腺症
搬运NaOH时口腔内被灼伤	口腔和咽喉部损伤
异常子宫出血排卵障碍	异常子宫出血
淋巴组织细胞增生症	淋巴组织增生
缺铁缺钙取药补充维生素AD取药	铁缺乏##钙代谢紊乱
右乳非特殊类型浸润性癌 T2N1M0 IIB期	乳腺恶性肿瘤##癌##淋巴结继发恶性肿瘤
肺癌晚期，血尿待查	肺恶性肿瘤##癌##血尿
距肛门15cm8cm管状腺瘤	管状腺瘤##直肠良性肿瘤
CA199CA242CEA增高原因未明	CA199升高##CEA升高##肿瘤标记物升高
冠心病急性非ST段抬高型心肌梗死	急性非ST段抬高型心肌梗死##冠状动脉粥样硬化性心脏病
鼻咽癌综合治疗后	鼻咽恶性肿瘤##癌
"右肺癌术后疼痛免疫功能,咳血抗过敏维生素不足叶酸不足,行动不便便秘重度疼痛抗过敏化疗,口腔溃疡高血压,化疗呕吐食欲减退"	肺术后##右肺恶性肿瘤##咯血##维生素缺乏##叶酸缺乏##便秘##疼痛##口腔黏膜溃疡##高血压##化疗药物反应##呕吐##食欲不振##癌
黏膜组织示鳞状上皮化生符合黏膜白斑	"白斑病,不可归类在他处者"
FD肝曲综合征	肠易激综合征##消化不良
肾母细胞瘤化疗	肾恶性肿瘤##肾母细胞瘤##化学治疗
c病毒性疹	病毒性皮疹
多发神经纤维瘤病	神经纤维瘤病[VonRecklinghausen病]
肩部色素斑	色素沉着未特指的疾患
眼睑出血点待查	出血斑点
肺纤维瘤	肺良性肿瘤##纤维瘤
肺炎胃肠炎	肺炎
腘绳肌腱膜炎	肌腱炎
肥厚型梗阻性心肌病	肥厚性梗阻性心肌病
双侧胸腔积液伴肺炎	胸腔积液##肺炎
鼻咽粘膜呈慢性炎免疫组化CK-	慢性鼻咽炎
躯体病样精神障碍	躯体化障碍
原发不孕结核性	原发不孕##结核感染
左侧腰骶部血管性肿瘤	躯干血管瘤
盲肠1升结肠2管状腺瘤伴低级别上皮内瘤变	盲肠良性肿瘤##升结肠良性肿瘤##管状腺瘤
左踝部蜂蜇伤	蜂螫伤##踝部损伤
下肢曲张静脉剥离术	下肢静脉曲张
陈旧型心梗心功IV级	心功能IV级(NYHA分级)##陈旧性心肌梗死
前列腺肥大伴小囊肿	前列腺增生##前列腺囊肿
颈肌筋膜炎	筋膜炎
Z足癣继发感染	足癣##足感染
左侧输卵管闭塞	输卵管梗阻
自体造血干细胞移植后纵隔右肺门复发	自体造血干细胞移植状态
右小腿筋膜间隙综合征后遗症	下肢骨筋膜室综合征
肝右后叶挫伤	肝挫伤
扭伤咽炎上感肾虚	咽炎##上呼吸道感染
右第七肋骨增大肋骨异常纤维增殖症	肋骨纤维异常增殖症
多发性陈旧性腔隙性脑梗塞	腔隙性脑梗死
滑膜软骨瘤	软骨瘤##滑膜良性肿瘤
耳后颈部淋巴结肿痛	颈淋巴结肿大
双眼外直肌后徙术后	眼术后
纵膈、左肺门淋巴结转移胸膜转移不除外	肺门淋巴结继发恶性肿瘤##纵隔淋巴结继发恶性肿瘤##O##转移性肿瘤
腹腔粘液腺癌化疗	腹部恶性肿瘤##粘液腺癌##化学治疗
化学灼伤6%面颈部躯干	躯干化学伤
子宫纵膈切除术后	子宫纵隔##子宫术后
宫颈cin-3宫腔不均质回声性质待查	子宫颈上皮内瘤变III级[CINIII级]
前纵裂及基底池血肿	蛛网膜下腔血肿##颅内血肿
停经234周院外B超提示左侧肾盂增宽	停经
左眼黄斑区神经上皮层线脱离双眼老年性白内	老年性白内障##视网膜脱离
右腕背撕脱性骨折	股骨内髁骨折
右股骨颈骨折取除骨折内固定装置	取出骨折内固定装置##股骨颈骨折
喉上神经炎	单神经炎
双眼渗出液视网膜神经上皮脱离	渗出性视网膜脱离
中-重度肺动脉高压	中度肺动脉高压##重度肺动脉高压
C4-6椎间盘突出	颈椎间盘突出
胸下段食管鳞状细胞癌	食管胸下段恶性肿瘤##鳞状细胞癌
生殖器结核	结核感染
腰髂韧带劳损	腰椎和骨盆其他和未特指部位的扭伤和劳损
食管癌''高血压	食管恶性肿瘤##癌##高血压
阿尔茨海默病重度痴呆	阿尔茨海默病性痴呆
胰腺导管内粘液样瘤	粘液瘤##胰腺良性肿瘤
右腕部尺神经瘤	神经瘤##尺神经良性肿瘤
右侧豌豆骨不全性骨折	豆骨骨折
胃窦多发性管状腺瘤	胃良性肿瘤##管状腺瘤
风湿性心瓣膜狭窄	风湿性心脏病##心脏瓣膜病
"哮喘,缺锌"	支气管哮喘##锌缺乏
肺炎肿瘤多处转移全身痛不能进食	肺炎##多部位继发恶性肿瘤##全身疼痛##进食障碍
"中耳炎(术后,左)"	耳术后##中耳炎
乙状结肠隆起型粘液腺癌（pT4aN0M1a IVA期）	乙状结肠恶性肿瘤##粘液腺癌
胆囊切开取石术后	胆囊结石##胆囊术后
滴虫炎	未特指的滴虫病
重度免疫相关性血细胞减少症	免疫相关性血细胞减少症（IRP）
胸背部疼痛待查	胸段背痛
左足第一跖趾关节红肿姆外翻	足拇外翻
2型糖尿病糖尿病周围神经病变糖尿病肾损害	2型糖尿病##2型糖尿病性周围神经病##2型糖尿病性肾病
手部血管瘤	肢端血管瘤
肾上腺发育不全	肾上腺发育不良
胃肠积气	胃胀气##肠胀气
急性移植物抗宿主反应病IV度肝脏肠道	急性移植物抗宿主病
神经系统特指疾患发作性肢体无力待查	神经系统病变##肢体无力
"2型糖尿病,糖尿病伴神经并发症,糖尿病伴有肾的并发症,其他特指的"	2型糖尿病##2型糖尿病伴神经系统并发症##非胰岛素依赖型糖尿病伴有肾的并发症
咳嗽变异性哮喘？支气管炎，百日咳综合症？	咳嗽变异型哮喘##支气管炎##百日咳
卵圆孔未闭可能左室松弛减退	卵圆孔未闭
宫颈非角化型鳞癌IIIb期放化疗后	子宫颈恶性肿瘤##鳞状细胞癌##化学治疗##恶性肿瘤放疗
右乳浸润性导管癌化疗后	乳腺恶性肿瘤##浸润性导管癌##化学治疗
多处皮肤撕裂伤（污染严重）头皮血肿多处软组织损伤脑伤？内脏损伤？	多处撕裂伤##头皮血肿##多处损伤##创伤性脑损伤
关节炎更综症	关节炎##更年期综合征
胆管细胞ca	肝胆管细胞癌
肾病骨病	肾性骨病
隐睾右侧	单侧隐睾
双眼周色素沉着	色素沉着其他特指的疾患
左侧海马区硬化并萎缩	海马硬化[颞叶内侧硬化]
咳嗽(乏力)	咳嗽##乏力
急性IV度GVHD累及肠道皮肤肝脏	急性移植物抗宿主病
胎盘后低回声团胎盘早剥	胎盘早期剥离
皮脂腺囊肿并感染	皮脂腺囊肿##感染
面颈部放疗后淋巴回流障碍	淋巴回流障碍##放射治疗
外阴paget病后	乳房以外的佩吉特病##外阴恶性肿瘤
高血压病肾病	高血压性肾病
腰骶部椎管囊肿	椎管囊肿
右膝髋关节病变待查	膝关节病##髋关节病
腺性膀胱炎术后复查	腺性膀胱炎##膀胱术后
鼻咽未分化型非角化行癌T4N2M0	鼻咽恶性肿瘤##癌
下唇黏膜扁平苔藓伴轻糜免疫异常	口腔扁平苔癣
妊娠32+周，前置胎盘？	孕32周##前置胎盘
智力发育不全	发育迟滞
1.妊娠合并盆腔包块性质待查2.G1P0孕30+6周待产LOA	盆腔肿物##孕30周
功能性肠紊乱	肠功能紊乱
胃恶性肿瘤的支持治疗	胃恶性肿瘤##恶性肿瘤支持治疗
G宫内妊娠	妊娠状态
左足3趾黑色素沉着	其他黑色素沉着过度
不育睾丸内硬结	男性不育症##睾丸结节
右肺小细胞肺癌维持性化学治疗	右肺恶性肿瘤##小细胞癌##恶性肿瘤维持性化学治疗
咽喉炎，感冒;右侧肺炎，糖尿病	咽炎##喉炎##感冒##肺炎##糖尿病
右侧海绵窦癌	颅内恶性肿瘤##癌
右臀部创伤性黄色肉芽肿性炎	黄肉芽肿
处女膜破裂出血	处女膜撕裂伤##出血
肝硬化乙肝	乙型肝炎肝硬化
特指胎盘疾病胎盘低置状态羊水减少	未特指的胎盘疾患##低置胎盘##妊娠合并羊水过少
右侧额颞顶枕叶及右基底节区大面积脑梗死	大面积脑梗死##基底节脑梗死
"右肺腺癌IV期疼痛,特发性肺间质纤维化,2型糖尿病 高血压病 甲状腺结节 胆囊结石伴胆囊炎,便秘"	右肺恶性肿瘤##疼痛##腺癌##特发性肺间质纤维化##2型糖尿病##高血压##O##胆囊结石伴胆囊炎##便秘
乙状结肠癌术后复查 慢支 化疗	结肠术后##乙状结肠恶性肿瘤##慢性支气管炎##化学治疗##癌
子宫纵隔(不全)	子宫不全纵隔
双颈部淋巴结反应性增生	颈淋巴结肿大
会阴裂伤I度裂伤	会阴部裂伤
高渗性高血糖状态	血糖升高
月经增多原因待查宫内节育环嵌顿	避孕环嵌顿##月经过多
AECOPD慢性肺心病失代偿期	慢性肺源性心脏病##慢性阻塞性肺疾病
肺癌癌痛	肺恶性肿瘤##癌##癌性疼痛
胃体小弯侧低分化腺癌pT4a	胃小弯恶性肿瘤##腺癌
侵及口咽壁、口咽旁	咽部继发恶性肿瘤
左小腿皮肤撕脱伴皮肤组织缺损	小腿撕脱伤##下肢皮肤缺损
结核性胸水	结核性胸腔积液
子宫颈鳞癌IIIB期放化疗后	子宫颈恶性肿瘤##鳞状细胞癌##恶性肿瘤放疗##化学治疗
高血脂，脂肪肝，肝酶异常	高脂血症##脂肪肝
腰椎间髋骨退行性变	腰椎退行性病变##髋骨关节病
脑梗塞高血压眩晕阴虚肝风	脑梗死##高血压##眩晕
右小腿截肢肢麻痹证气滞血瘀	截肢
非霍奇金弥漫大B细胞淋巴瘤ⅡE期A组	非霍奇金淋巴瘤##弥漫大B细胞淋巴瘤
升主动脉-主动脉弓壁间血肿并破裂	主动脉壁内血肿
盆底功能障碍性疾病阴道前壁膨出I期	阴道脱垂##盆底功能障碍
左下肢坏死组织查见真菌菌丝	真菌感染
右上肢及胸腹部锯割伤	上肢开放性损伤##胸部开放性损伤##腹部开放性损伤
脑脱髓鞘改变脑缺血发作	脱髓鞘性脑病##脑血管供血不足
外阴血管黏液瘤	外阴良性肿瘤##血管粘液瘤
癌症化放疗	癌症##恶性肿瘤放疗##化学治疗
1左膝髌内侧滑膜皱襞综合征	膝关节滑膜皱襞综合征
胎-胎输血综合征供血者	双胎输血综合征
腋窝淋巴结继发癌	腋窝淋巴结继发恶性肿瘤
造瘘口肠脱出	胃肠道的其他人工造口状态
左肺静脉栓塞	静脉栓塞
左乳浸润性导管癌 pT2N2M0 III期	乳腺恶性肿瘤##浸润性导管癌##淋巴结继发恶性肿瘤
颅脑外伤性意识障碍后遗症期	头部损伤##意识障碍
骨关节炎；痹症；肝肾不足	骨关节病
宫颈上皮内瘤变III	子宫颈上皮内瘤变III级[CINIII级]
右肺癌治疗后	右肺恶性肿瘤##癌
皮肤瘙痒症待查老年瘙痒症可能	瘙痒症
会厌肿物	喉肿物
右卵巢生发上皮包涵囊肿	卵巢包涵囊肿
右跟骨劳损	足的其他和未特指部位的扭伤和劳损
结肠癌并肠梗阻	结肠恶性肿瘤##肠梗阻##癌
双颞硬膜血肿上矢状窦动静脉漏	脑动静脉瘘
双眼白塞氏病	白塞病[behcet病]
感染性发热皮肤软组织感染	感染性发热
右手陈旧性扭伤	手其他和未特指部位的扭伤和劳损
右乳浸润性导管癌生物治疗	乳腺恶性肿瘤##浸润性导管癌##恶性肿瘤生物治疗
右肺上叶鳞癌	右肺上叶恶性肿瘤##鳞状细胞癌
植物状态肌张力增高	肌张力障碍
脑内多发腔隙性梗塞	腔隙性脑梗死##多发性脑梗死
停经256周B超提示胎儿双足内翻状态	妊娠状态##先天性内翻足
左下肢臀部皮肤改变陈旧性皮肤压疮	压疮
右侧腋下皮脂腺囊肿	皮脂腺囊肿
甲状腺滤泡癌	甲状腺恶性肿瘤##滤泡性癌
鼻咽顶后壁、顶壁、右侧壁未分化型非角化性癌T1N0M0 I期	鼻咽顶恶性肿瘤##鼻咽侧壁恶性肿瘤##未分化的癌
乳头增大溢液	乳头溢液##乳头肥大
腰膝病变下肢交感神经病变	未特指的自主神经系统疾患
血小板减少性紫癜	特发性血小板减少性紫癜
右侧桡骨远端开放性骨折	桡骨远端骨折##上肢开放性骨折
维生素不足消化功能紊乱	维生素缺乏##胃肠功能紊乱
卵巢癌IIIC期	卵巢恶性肿瘤##癌
右脚肿痛	下肢疼痛
右顶脑血管畸形伽马刀治疗后	脑血管畸形
取出大股骨内固定装置	取出内固定装置
肺大细胞癌T4N3M0	肺恶性肿瘤##大细胞癌##淋巴结继发恶性肿瘤
右肾切开取石术后	肾结石##肾术后
2型糖尿病糖尿病足部病变	2型糖尿病##2型糖尿病足
心衰红皮病嗜酸性粒细胞增多症	嗜酸粒细胞增多综合征##红皮病##心力衰竭
横结肠管状腺瘤直乙交界管状腺瘤	直肠乙状结肠连接部良性肿瘤##横结肠良性肿瘤##管状腺瘤
右下肺腺癌化疗后	右肺下叶恶性肿瘤##腺癌##化学治疗
"高血压病,脑血管病，过敏性鼻炎，抑郁症，便秘"	高血压##脑血管病##过敏性鼻炎[变应性鼻炎]##便秘##抑郁症
左胫骨平台开放性粉粹性骨折伴骨质部分缺损	胫骨骨折
宫颈中高分化鳞癌IIIb期放化疗后	子宫颈恶性肿瘤##鳞状细胞癌##化学治疗##恶性肿瘤放疗
胸膜膈肌钙化斑	胸膜钙化##肌肉的其他钙化
左股骨腓骨骨质改变骨纤维结构不良	腓骨纤维结构不良##股骨纤维结构不良
纵隔霍奇金淋巴瘤	纵隔淋巴瘤##霍奇金淋巴瘤
乙状结肠术后化疗	恶性肿瘤术后化疗
宫颈低中分化鳞癌IIIb期放化疗后	子宫颈恶性肿瘤##鳞状细胞癌##化学治疗##恶性肿瘤放疗
喉癌放疗后	喉恶性肿瘤##癌##恶性肿瘤放疗
慢性嗜酸细胞白血病	慢性嗜酸性粒细胞白血病[高嗜酸性粒细胞增多症]
不完全性房室干扰脱节伴交界性逸搏心律	结性逸搏
双侧胫骨应力性损伤	胫骨骨折##应力性骨折
右侧卵巢高级别浆液性腺癌IIIc期	卵巢恶性肿瘤##浆液性腺癌
降结肠溃疡型中分化腺癌	降结肠恶性肿瘤##腺癌
HL经典型结节硬化型IIB期化疗后	结节硬化型经典霍奇金淋巴瘤##化学治疗
骶尾部化脓性囊肿	骨盆部囊肿
T11-12老年性病变或压缩性	胸椎压缩性骨折##胸椎骨折T11/T12
格林巴利综合征？高位脊髓病变？低钾？	吉兰-巴雷综合征##低钾血症##脊髓病
弥漫球性增生性狼疮性肾IV-G	狼疮性肾炎
血三系减低骨髓造血功能低下	全血细胞减少
宫内双死胎单绒双羊	双胎死产
右环指外伤性截指	单指完全离断
直肠溃疡型中分化乳头状管状腺癌	直肠恶性肿瘤##乳头状管状腺癌
肺癌ＩＶ期　卡氏评分８０分	肺恶性肿瘤##癌
右膝关节外侧盘状盘状半月板伴Ⅲ°撕裂	先天性盘状半月板##膝外侧半月板撕裂
先天性主动脉瓣畸形并中-重度关闭不全	先天性主动脉瓣畸形##先天性主动脉瓣关闭不全
回肠膀胱乳头新生物	小肠息肉##膀胱息肉
右拇指神经断裂	神经断裂
B超提示胎儿卵圆孔稍增大肾窦分离	卵圆孔未闭
中枢性低钠低氯	低钠血症##低氯血症
急性肠道移植抗宿主病I度	急性移植物抗宿主病
扁桃体炎，腹泻病，支气管炎;	扁桃体炎##O##支气管炎
盲肠升结肠横结肠管状腺瘤	盲肠良性肿瘤##升结肠良性肿瘤##横结肠良性肿瘤##管状腺瘤
非甲状腺病态吧综合征	甲状腺功能正常的病态综合征
原发性胆汁性硬化失代偿期	原发性胆汁型肝硬化##肝硬化失代偿期
右膝部挫擦伤	膝部挫伤##膝部擦伤
牙龈损伤	牙及相关组织损伤
左足第2趾右足第234缺血坏死	足坏死
子宫肌层恶性肿瘤平滑肌肉瘤	子宫恶性肿瘤##平滑肌肉瘤
"左肺腺癌IV期,便秘,贫血"	左肺恶性肿瘤##腺癌##便秘##贫血
椎基底A供血不足胃黏膜撕裂症	椎-基底动脉供血不全##胃损伤
右胫腓骨远端骨质破坏	骨质破坏
双眼视功能异常	视觉障碍
尿毒症肾透析 肾性贫血 肾性骨病 肾性高血压 神经衰弱	尿毒症##肾脏透析状态##肾性贫血##肾性骨病##肾性高血压##神经衰弱
慢性心功能不全心功能III级	心功能III级(NYHA分级)
颏部瘘道原因缝线反应	皮肤瘘管
幼年型粒-单核细胞白血病	幼年型粒单核细胞白血病
左侧髌骨骨梗死右膝髌股关节退变	单侧膝关节骨性关节病##骨坏死
双侧颈部淋巴结病变	淋巴结病
重型颅脑损伤术后2颅内感染	颅内损伤##脑术后##颅内感染
左腋部皮脂腺囊肿	皮脂腺囊肿
脾曲管状腺瘤I级	结肠脾曲良性肿瘤##管状腺瘤
慢性肠炎伴肠功能紊乱	慢性肠炎##肠功能紊乱
多脏器功能不全累及心肌肝脏凝血	多脏器功能障碍综合征[MODS]
慢性肾衰竭并急性肾衰竭	慢性肾衰竭##急性肾衰竭
符合横结肠低级别绒毛管状腺瘤	横结肠良性肿瘤##管状绒毛状腺瘤
前列腺增生伴出血	前列腺增生##出血
"乳腺结节,"	乳房占位
宫颈小细胞癌IIA2期	子宫颈恶性肿瘤##小细胞癌
先天性染色体病45XXrob1315	先天性染色体病
急性T淋巴细胞白血病伴髓系表达	T淋巴细胞和髓系混合表型急性白血病
糖尿病糖尿病肾病糖尿病视网膜病变	糖尿病##糖尿病性肾病##糖尿病性视网膜病变
右侧额叶占位伴出血	额叶出血##脑占位性病变
胰腺癌术后腹腔广泛转移 肺转移？	胰腺恶性肿瘤##癌##肺继发恶性肿瘤##腹腔继发恶性肿瘤##转移性癌##广泛转移性肿瘤
纠正性大动脉转位	矫正性大动脉转位
慢性移植物抗宿主反应病皮肤口腔肝脏眼	慢性移植物抗宿主病
子宫原位癌	子宫恶性肿瘤##原位癌
右乳多发纤维腺瘤	乳腺良性肿瘤##纤维腺瘤
绝经后子宫	绝经期
咯血(感染?)	感染##咯血
鳞状上皮化生伴CINⅠCINⅡ累及腺体	子宫颈上皮瘤样病变[CIN]I级##宫颈上皮瘤样病变[CIN]II级
脑器质性疾病所致情绪障碍	器质性心境[情感]障碍
宫颈管占位、粘膜下肌瘤	子宫粘膜下平滑肌瘤##子宫及附件占位
先天性青光眼	先天性水眼[眼积水]
卵巢癌IV期第二次化疗后	卵巢恶性肿瘤##化学治疗##癌
左肱骨下端骨不连	肱骨骨折不连接
右侧多囊卵巢	卵巢多囊样改变
导管轻度扩张伴局部导管上皮乳头状增生	乳腺导管扩张症##乳腺增生
贫血血小板高2周	贫血##血小板增多
左足皮瓣臃肿术中诊断左足皮瓣臃肿	皮瓣移植状态
"肝癌,肝硬化,肝昏迷"	肝恶性肿瘤##肝硬化##肝性脑病##癌
火焰烧伤左手	手部烧伤##火焰烧伤
右肺中叶腺癌治疗后的随诊检查	右肺中叶恶性肿瘤##腺癌##恶性肿瘤其他治疗后的随诊检查
左侧跟骨外侧及内踝下方撕脱性骨折	内踝骨折##跟骨骨折
面部白斑原因待查蛔虫症可能	"白斑病,不可归类在他处者##蛔虫病"
胆道疾患先天性胆道闭锁可能性大	先天性胆管闭锁##胆道未特指的疾病
中分化宫内膜样腺癌	子宫内膜样腺癌##子宫内膜恶性肿瘤
慢性肾脏病并急性肾衰	慢性肾病##急性肾衰竭
尿路上皮癌术后	尿路上皮癌##尿道术后
左肾低密度影请结合超声除外囊肿	泌尿器官诊断性影像检查的异常所见
无精症右阴囊内占位	无精子症##男性生殖器占位
停经266周B超提示胎儿双侧外耳外观异常	妊娠状态
右侧输卵管伞端闭锁伴输卵管积液	右侧输卵管积水##输卵管闭锁
肺部结节影待查	肺部阴影
双侧腹股沟清扫后TIP辅助化疗	化学治疗
复发性滤泡淋巴瘤	滤泡淋巴瘤##恶性肿瘤复发
胎儿宫内生长发育受限	胎儿生长受限
面神经麻痹(面瘫)	神经麻痹
CHB后硬化	慢性乙型病毒性肝炎##乙型肝炎肝硬化
水源性肢端角化	角化病
溃疡浸润型低分化腺癌	腺癌
胸髓病变伴截瘫	截瘫[双下肢瘫痪]
全身多处犬咬伤术后	多处开放性损伤##被狗咬伤
子宫(肌)瘤	子宫平滑肌瘤##子宫平滑肌瘤
胃肠道发育畸形	先天性消化道畸形
右侧输尿管上段结石并右肾重度积水	肾积水伴输尿管结石
左肺下叶支气管扩张症	支气管扩张症
神经精神发育延迟	发育迟滞
宫颈上皮内低级别病变CINI级	子宫颈上皮瘤样病变[CIN]I级
"高龄,肺占位,肺癌可能大"	肺占位性病变##肺恶性肿瘤##癌
血液透析导管相关性感染	透析导管引起的机械性并发症##血管导管相关性感染
左腕软组织割伤	腕部开放性损伤
EST柱状球囊扩张术胆管取石术ENBD后	胆管结石##胆道术后
亚急性淋巴结炎	淋巴结炎
左肾造瘘管口伤口漏尿	肾造口状态
发育不良待查	先天性发育异常
乳癌病【痰瘀互结证】	乳腺恶性肿瘤##癌
食管溃疡浸润型中分化鳞状细胞癌	食管恶性肿瘤##鳞状细胞癌
左腹部臀部肿瘤	腹部肿瘤##臀部肿瘤
右膝髌骨局灶性坏死内侧OA	单侧膝关节骨性关节病##骨坏死
小儿唐氏综合征	21-三体综合征[Down综合征]
乙状结肠病变并不全梗阻	不完全性肠梗阻
多饮多尿待查	多尿##多饮
白细胞淤滞-不除外血液病	血液和造血器官未特指的疾病
左眼暴露性角膜病变	角膜未特指的疾患
颈椎神经纤维瘤	神经纤维瘤病[VonRecklinghausen病]
右肺上叶大细胞癌中医治疗	右肺上叶恶性肿瘤##大细胞癌##恶性肿瘤中医治疗
鼻咽未分化非角化癌T2N2M0	鼻咽恶性肿瘤##未分化的癌
胸脊髓损伤并不全瘫	胸部脊髓损伤##不完全性瘫痪
右下肺鳞术后（pT4N2M0	右肺下叶恶性肿瘤##肺术后##鳞状细胞癌
阵发性心房颤动心房纤颤	阵发性心房颤动
骨转移(左11后肋、右9后肋)	肋骨继发恶性肿瘤##转移性肿瘤
后交通动脉瘤术后	后交通动脉动脉瘤
左乳包块，孕8月	乳房肿物##孕32周
内侧副韧带股骨止点撕脱性骨折	股骨骨折
健康查体; 肺癌待查	健康查体##肺恶性肿瘤##癌
胃癌IV期化疗后	胃恶性肿瘤##化学治疗##癌
成人斯蒂尔病合并肺间质改变	成年型斯蒂尔病[Still病]
直肠低分化腺癌	直肠恶性肿瘤##腺癌
动脉导管迟缓关闭	动脉导管未闭
左肺上叶舌段部分支气扩张周围少许纤维灶	支气管扩张症
皮疹待查：小儿康疹？肠蛔虫症？	皮疹##白色糠疹##肠蛔虫病
"直肠癌晚期,肝转移，化疗"	直肠恶性肿瘤##肝继发恶性肿瘤##化学治疗##癌##转移性癌
胰头中分化腺癌	胰头恶性肿瘤##腺癌
纤维结构异常增殖症左股骨近端左胫骨	股骨纤维结构不良##胫骨纤维结构不良
右手示指末节部分坏死伴骨外露	手坏死
上呼吸道感染，腹泻，	上呼吸道感染
先天性神经性肌强直	先天性肌强直症[Thomsen病]##神经性肌强直[艾萨克斯综合征]
宫颈中分化鳞形细胞癌	子宫颈恶性肿瘤##鳞状细胞癌
高甘油三脂高尿酸	高甘油三酯血症##高尿酸血症
外伤，支气管炎	支气管炎
多发性梗塞椎基底A供血不足	椎-基底动脉供血不全
凝血障碍慢性DIC可能	凝血功能障碍##弥散性血管内凝血
白内障人工晶体置换术后	白内障##人工晶体植入状态
右踝关节开放性骨折伴脱位	踝关节脱位##踝关节骨折
味觉缺失	味觉障碍
宫颈鳞状细胞癌IIIB期放化疗后	子宫颈恶性肿瘤##鳞状细胞癌##化学治疗##恶性肿瘤放疗
十二指肠空肠绒毛萎缩部分淋巴管扩张	肠淋巴管扩张
痹症腰腿痛手麻木感冒前列腺肥大	腰痛##下肢疼痛##感冒##前列腺增生
完全性肺静脉异位引流心下型梗阻型	"完全性肺静脉异位引流,心下型"
大疱性表皮坏死松解萎缩性药疹	莱尔综合征[lyell综合征]
浮肿查因肝源性心源性肾源性营养不良性	营养性水肿##水肿
痛经，IUD	痛经##具有子宫内避孕装置
"原发性肝癌,慢性乙型病毒性肝炎,肝炎后肝硬变,门脉癌栓"	肝恶性肿瘤##癌##慢性乙型病毒性肝炎##肝炎肝硬化##门静脉瘤栓
三脑室脑组织内血管异常性病变	脑血管病
左鼻前庭血管源性肿瘤考虑血管周细胞	鼻部血管瘤
十二指肠隆起型中低分化腺癌	十二指肠恶性肿瘤##腺癌
TSH增高原因非甲状腺病态综合征	甲状腺功能正常的病态综合征
颞下颌关节功能紊乱病咀嚼肌功能紊乱	颞下颌关节紊乱病##肌肉疾患
肾组织慢性改变伴球性硬化	肾小球硬化
慢性乙型病素养性肝炎重型重度	病毒性肝炎乙型慢性重型
牙髓病龋病	牙髓和根尖周组织其他和未特指的疾病##龋病
口腔黏膜恶性肿瘤晚期	口腔黏膜恶性肿瘤
左膝关节局灶性骨梗死退变	单侧膝关节骨性关节病##骨坏死
2型糖尿病##糖尿病肾病	2型糖尿病##糖尿病性肾病
上颌窦癌	上颌窦恶性肿瘤##癌
右食指创伤性软组织缺损伴甲床缺损	后天性指缺损
右腓肠肌肌肉拉伤	腓侧肌群和肌腱损伤
右乳恶性分叶状肿瘤	乳腺恶性肿瘤##恶性叶状瘤
鼻咽鳞状细胞癌放化疗后	鼻咽恶性肿瘤##鳞状细胞癌
4%烫伤额面部左胸部左上肢浅II度	上肢烫伤##躯干部烫伤
高血脂心脏损害	未特指的心脏病##高脂血症
蜂窝组织炎	蜂窝织炎
西医1抑郁症伴焦虑2老年性脑改变	抑郁发作##焦虑状态
右颞叶海马异常信号缺血脱髓鞘改变	脱髓鞘性脑病##脑血管供血不足
类风湿性关节炎重度	类风湿性关节炎
T1012椎体压缩性骨折病理性骨折不除外	胸椎压缩性骨折##病理性骨折
胆囊息肉胆囊结石	胆囊息肉##胆囊结石
特指听觉丧失右耳听觉丧失	其他特指的听觉丧失
Carolis病	先天性肝内胆管囊状扩张症[Caroli病]
头腹部左侧臀部打伤	头部损伤##腹部损伤##被别人殴打、踢、拧、咬或抓伤##多处损伤
左上肢跌伤待查	摔伤##上肢损伤
颈动脉粥样硬化伴斑块形成	颈动脉粥样硬化
新生儿高胆红素血症，ABO溶血？	新生儿高胆红素血症
胎盘前置状态并胎盘边缘剥离	前置胎盘##胎盘早期剥离
（阴茎）高分化鳞状细胞癌	阴茎恶性肿瘤##鳞状细胞癌
右肺上叶鳞癌（pT2aN2M0 IIIa期）术后	肺术后##右肺上叶恶性肿瘤##鳞状细胞癌##淋巴结继发恶性肿瘤
S2-3椎管囊性病灶	椎管囊肿
右卵巢子宫内膜样腺癌	卵巢恶性肿瘤##子宫内膜样腺癌
右输卵管高级别浆液性腺癌	输卵管恶性肿瘤##浆液性腺癌
慢性淤胆性脾肿大	脾大
神经系统特指疾患双侧额叶斑片状高信号影	"神经系统的其他疾患,不可归类在他处者##中枢神经系统诊断性影像检查的其他异常所见"
耳带状庖疹	外耳带状疱疹
右拇指狗牙齿划伤	拇指开放性损伤##被狗咬伤
咽壁恶性肿瘤	咽壁恶性肿瘤##咽炎
双肺多发斑片及磨玻璃影	肺部阴影
腹腔内肉瘤	腹部恶性肿瘤##肉瘤
前胸瘢痕疙瘩	瘢痕疙瘩
心肺功能失代偿期-心功能III级	心功能不全##心功能III级(NYHA分级)
"贲门癌,胃镜用药 预防出血"	贲门恶性肿瘤##癌
臀部疖肿金黄色葡萄球菌	臀部疖##金黄色葡萄球菌感染
损伤(右额部)	头部损伤
非萎缩性胃炎	胃炎
右额部肿块	头部占位
右乳浸润性癌内分泌治疗	乳腺恶性肿瘤##浸润性导管和小叶性癌##恶性肿瘤内分泌治疗
声门癌	声门恶性肿瘤##癌
偶发房性早博	房性期前收缩[房性早搏]
左股骨中段癌	股骨恶性肿瘤##癌
左肾透明细胞癌术后多发骨转移	肾术后##肾恶性肿瘤##透明细胞癌##骨继发恶性肿瘤##转移性透明细胞癌
直肠结肠粘膜低级别管状及绒毛管状腺瘤	直肠良性肿瘤##管状绒毛状腺瘤
高血压Ⅲ;高脂血症;周围神经病;脑梗死;骨质疏松	高血压3级##高脂血症##多发性神经病[多发性神经炎/周围神经炎]##脑梗死##骨质疏松
左肱骨中下段不全骨裂	肱骨骨折
双子宫颈	双子宫颈
扁平苔藓硬化性萎缩性苔藓	扁平苔癣
粟粒大结肠黏膜组织1块呈低级别管状腺瘤	结肠良性肿瘤##管状腺瘤
睡眠增多症(？)	嗜眠症
神经鞘膜瘤	神经鞘瘤
脑膜瘤放疗后	脑膜瘤##恶性肿瘤放疗
肝局灶增生血脂高	高脂血症
右肺下叶小细胞癌广泛期	右肺下叶恶性肿瘤##小细胞癌
慢性移植物抗宿主反应病上肢皮肤四肢关节	慢性移植物抗宿主病
共同心房	单心房
膀胱阴道瘘术后;	膀胱阴道瘘##膀胱术后
性功能减退	性功能障碍
冠心病糖尿病关节炎	冠状动脉粥样硬化性心脏病##糖尿病##关节炎
溃疡型腺癌	腺癌
颈动脉粥样硬化(混合斑)	颈动脉粥样硬化
右上腹皮肤麻木	皮肤感觉异常
Ｂ型血友病[克里斯马斯病]	B型血友病
胃肠炎支气管炎复诊	胃肠炎##支气管炎
"脑梗死,记忆力减退,高脂血症,骨质疏松"	脑梗死##高脂血症##骨质疏松
双侧胸水少量尿蛋白阳性待查	胸腔积液
低钙儿童异常动态脑电图	钙代谢紊乱##脑电图异常
卵巢癌Ⅳ期	卵巢恶性肿瘤##癌
脑白质变性5神经症	脑白质病##神经症性障碍
急性支气管炎?哮喘?	急性支气管炎##支气管哮喘
1肺癌骨转移；2截瘫	肺恶性肿瘤##骨继发恶性肿瘤##未特指的截瘫##癌##转移性癌
胃肠功能紊乱，疝气	胃肠功能紊乱
双耳先天性极重度感音神经性聋	双侧感音神经性聋##先天性聋
乏力，肝异常回声区	乏力
; 直肠癌术后; 内痔	直肠术后##直肠恶性肿瘤##内痔##癌
皮下纤维瘤	纤维瘤
宫颈激光术后	宫颈术后
左侧股骨及髋臼骨纤维结构不良	髋骨纤维异常增殖症##股骨纤维结构不良
左下肢恶性纤维组织细胞病	下肢恶性肿瘤
右上肺鳞状细胞癌介入治疗后	右肺上叶恶性肿瘤##鳞状细胞癌
面部及左前臂蜂蜇伤	蜂螫伤##面部损伤##前臂损伤
子宫颈鳞癌IIB期放疗后	子宫颈恶性肿瘤##鳞状细胞癌##恶性肿瘤放疗##化学治疗
上呼吸道疾病细菌性	上呼吸道感染##细菌感染
血管结构畸	血管畸形
肺占位，前纵膈占位，重症肌无力	肺占位性病变##胸腔占位性病变##重症肌无力
口腔灼伤性溃疡	口腔开放性损伤##溃疡性口炎
右眼裂外眦外伤后疤痕粘连	外眦瘢痕
左股骨骨质破坏区姑息性放疗后	骨质破坏##姑息医疗##放射治疗
结性逸搏律一过性全心停搏	心脏停搏##结性逸搏
左小腿软组织劳损	累及下肢多个部位的脱位、扭伤和劳损
右肾母细胞瘤化疗后	肾恶性肿瘤##肾母细胞瘤##化学治疗
甲状旁腺功能减退症	甲状旁腺功能减退
降结肠管状腺瘤乙状结肠绒毛状-管状腺瘤	降结肠良性肿瘤##乙状结肠良性肿瘤##管状腺瘤##管状绒毛状腺瘤
肝癌术后复发介入治疗后双肺转移	肝术后##肝恶性肿瘤##癌##肺继发恶性肿瘤##转移性癌
滋养细胞肿瘤IV12第二次诱导化疗后	滋养细胞病##化学治疗
精神运动发育迟缓代谢病	发育迟滞
1多发性脑缺血2高同型半胱胺	脑血管供血不足##高同型半胱氨酸血症
符合跖骨头坏死改变	骨坏死
传染性单核细胞增多症	未特指的传染性单核细胞增多症
右上肢疤痕挛缩粘连	瘢痕挛缩##瘢痕粘连
胃病变粘膜下剥离术ESD	胃和十二指肠未特指的疾病
瘢痕溃疡	瘢痕
腹痛：胃肠道寄生虫感染	腹痛##肠道寄生虫病
直肠癌新辅助放化疗后	直肠恶性肿瘤##恶性肿瘤放疗##化学治疗##癌
短暂性脑缺血高三酰甘油血症	短暂性脑缺血发作##高甘油三酯血症
1.肝癌术后复发多次栓塞术后	肝术后##肝恶性肿瘤##癌##恶性肿瘤复发
骶尾部左髋部压迫性溃疡	压疮
原发性支气管肺癌(右肺鳞癌，rT1cN2M1c(脑)，IVB期，PS0分)	右肺恶性肿瘤##鳞状细胞癌
右乳腺癌中医治疗	乳腺恶性肿瘤##恶性肿瘤中医治疗##癌
右肾肾实质萎缩伴多房囊性变	肾囊肿##肾萎缩
主动脉瓣换瓣术后	具有其他心脏瓣膜置换
"多发性骨髓瘤(LAM轻链型),D-S分期IIIB期,ISS分期III期"	多发性骨髓瘤(轻链λ型)##多发性骨髓瘤(ISS分期III期)##多发性骨髓瘤(DS分期III期B组)
左背部玻璃割伤	背部开放性损伤##玻璃割伤
急性肝肾凝血等功能衰竭	多脏器功能衰竭
结肠多发管状腺瘤伴高级别上皮内瘤变	结肠良性肿瘤##管状腺瘤
"行动不便,肝肾阴虚、腰膝酸软,咽炎,慢性失眠,便秘"	咽炎##失眠##便秘
胰腺癌史	胰腺恶性肿瘤史
右下牙龈高分化鳞状细胞癌	牙龈恶性肿瘤##鳞状细胞癌
双乳腺病伴部分导管扩张和上皮大汗腺化	乳房未特指的疾患##乳腺导管扩张症
溶血原因自身免疫性溶血可能性大	自身免疫病
颈内颅内段动脉血管多发狭窄并斑块形成	动脉狭窄##颈内动脉狭窄##颈内动脉斑块
脑缺血并周围神经病変脑记忆力减退	脑血管供血不足##多发性神经病[多发性神经炎/周围神经炎]
右乳乳腺纤维腺瘤	乳腺良性肿瘤##纤维腺瘤
1.冠心病，陈旧前壁心梗，PTCA+支架术后；2.高血压病2级（极高危）；3.高脂血症。	冠状动脉粥样硬化性心脏病##陈旧性前壁心肌梗死##冠状血管成形术后状态##血管支架植入术后状态##O##高脂血症
唐氏综合症先心病	21-三体综合征[Down综合征]##先天性心脏病
肝脏肿瘤：肝母细胞瘤？	肝恶性肿瘤##肝母细胞瘤##肝母细胞瘤
左髌骨骨折术后	髌骨骨折##骨折术后
肝占位性病变:肝癌	肝恶性肿瘤##癌##肝占位性病变
双叶甲状腺乳头状癌	甲状腺恶性肿瘤##甲状腺乳头状癌
急性胆囊炎胆囊结石急性胃炎	急性胆囊炎##胆囊结石##急性胃炎
发热待查：化扁，肺炎？	发热##急性化脓性扁桃体炎##肺炎
右眼枪伤	意外枪伤##眼部开放性损伤
单纯疱疹病毒感染症	单纯疱疹
双乳多发性腺瘤	腺瘤##乳腺良性肿瘤
急性化脓性扁桃体炎，喘息性支气管炎	急性化脓性扁桃体炎##急性喘息性支气管炎
左小腿肿痛待查	下肢肿胀##下肢疼痛
1左膝关节外侧不全盘状半月板前角体部Ⅲ°	先天性盘状半月板
左结节性甲状腺肿 右甲状腺癌	结节性甲状腺肿##甲状腺恶性肿瘤##癌
双踝跌伤	踝部损伤##跌倒
先天性阴茎扭转	阴茎的其他先天性畸形
子宫颈鳞状细胞癌ⅢB期放化疗后	子宫颈恶性肿瘤##鳞状细胞癌##恶性肿瘤放疗##化学治疗
双眼浮肿过敏性疾病	眼睑水肿##过敏反应
中分化鳞形细胞癌	鳞状细胞癌
口咽干燥	口干
肩胛骨癌	肩胛骨恶性肿瘤##癌
胰腺特指疾病胰腺颈部密度欠均匀	胰腺其他特指的疾病
2型糖尿病性合并正中神经病变	2型糖尿病##正中神经损害
"胰腺癌放疗,肝转移? 血小板降低,化疗，食欲差"	胰腺恶性肿瘤##恶性肿瘤放疗##肝继发恶性肿瘤##血小板减少##化学治疗##食欲不振##癌##转移性癌
工伤综合征	工作中的意外损伤
双肺上叶陈旧性病变双肺下叶间质性病变	间质性肺病##肺病
左手拇指电锯割伤伸指拇长伸肌腱断裂	拇指开放性损伤##手部肌肉肌腱断裂
前列腺动态未定肿瘤	前列腺动态未定或动态未知的肿瘤
卵巢乳头腺液性腺癌术后	卵巢术后##乳头状浆液性腺癌##卵巢恶性肿瘤
右乳病变不排除恶性待石蜡	乳腺恶性肿瘤
脱髓鞘性脑白质病√	脱髓鞘性白质脑病
右眼糖尿病视网膜病变II期	糖尿病视网膜病(E10-E14+伴有共用第四位数.3)
双侧额叶基底节区多发腔隙性缺血梗塞灶	多发性脑梗死##腔隙性脑梗死##基底节脑梗死
肿瘤术后免疫治疗	恶性肿瘤术后免疫治疗
大肠肿物	肠占位
头痛口干肝肾不足	头痛##口干
慢性子宫颈炎(宫颈那囊)	慢性子宫颈炎##子宫颈纳包氏囊肿
右眼眼底黄斑变性	黄斑变性
肝错构瘤	肝错构瘤
椎基底动脉血栓形成	椎动脉血栓形成##基底动脉血栓形成
右侧软腭划伤	口腔和咽喉部损伤
慢性结石性胆囊炎伴胆固醇沉积	胆囊结石伴慢性胆囊炎##胆囊胆固醇沉着症
肝硬化（酒精性、肝炎后）	酒精性肝硬化##肝炎肝硬化
右肾血管平滑肌瘤可能	肾错构瘤
右股骨上段骨肉瘤	股骨恶性肿瘤##骨肉瘤
第1-2趾表面皮肤软组织割伤	趾部开放性损伤
子宫肉瘤术后复发	肉瘤##子宫恶性肿瘤##子宫术后##恶性肿瘤复发
大血管错位完全性——单纯性	大动脉转位
胰腺癌Ⅲ期	胰腺恶性肿瘤##癌
直肠癌5cm，术前放疗	直肠恶性肿瘤##恶性肿瘤术前放疗##癌
梗阻性黄疸PTCD及胆道支架置入术后	梗阻性黄疸##胆管支架置入术后
-慢性盆腔炎	盆腔炎
双足第5趾外侧皮肤灼伤	足部损伤
右侧大脑脚囊肿	脑囊肿
汗证厌食花剥舌夜惊配药	睡惊症[夜惊症]
皮炎腰腿痛	皮炎##下肢疼痛##腰痛
硬膜下硬膜外血肿	硬膜下血肿##硬膜外血肿
结肠管状腺瘤	结肠良性肿瘤##管状腺瘤
右肱骨头坏死半脱位	肱骨头缺血性坏死##髋关节半脱位
横结肠符合绒毛状管状腺瘤	横结肠良性肿瘤##管状绒毛状腺瘤
冠心心功不全	冠状动脉粥样硬化性心脏病##心功能不全
右肺中叶肺大疱	肺大疱
肺癌(骨转移)	肺恶性肿瘤##癌##骨继发恶性肿瘤##转移性癌
"升结肠癌,腹腔转移术后"	升结肠恶性肿瘤##癌##腹腔继发恶性肿瘤##转移性癌
右颌下静脉畸形	血管畸形
主动脉瓣钙化并轻度关闭不全	主动脉瓣关闭不全##主动脉瓣钙化
右侧椎动脉颅内段蛇形夹层改变	颅内椎动脉夹层
子宫发育异常	子宫畸形
右膝外翻重度左膝内翻轻度	膝外翻##膝内翻
胎盘疾病胎盘残留	胎盘部分残留不伴出血##未特指的胎盘疾患
乙状结肠中分化腺癌术后中医治疗	结肠术后##乙状结肠恶性肿瘤##腺癌##恶性肿瘤中医治疗
胰腺特指疾病胰体良性病变	胰腺其他特指的疾病
上感、肺炎恢复期、热性惊厥、颅内感染？	上呼吸道感染##肺炎##治疗后恢复期##热性惊厥##颅内感染
肾错构瘤破裂出血右	肾错构瘤破裂出血
缺铁低骨密度	铁缺乏##骨密度和结构疾患
右股静脉临时导管置管术已拔除	为肾透析的临时静脉拔管
右下肺腺癌伴双肺、右肾上腺、骨转移 cT3N3M1 IV期 EGFR19号外显子缺失突变 ALK未测	右肺下叶恶性肿瘤##腺癌##骨继发恶性肿瘤##肺继发恶性肿瘤##肾上腺继发恶性肿瘤##转移性腺癌##淋巴结继发恶性肿瘤
亚急性硬膜下血肿	硬膜下血肿
右拇指离断伤	拇指创伤性切断(完全)(部分)
右肺中叶腺癌化学治疗后的随诊检查	右肺中叶恶性肿瘤##腺癌##恶性肿瘤化学治疗后的随诊检查
面颈部刀伤	面部开放性损伤##颈部开放性损伤
骨质疏松，白细胞减少，抑郁症	骨质疏松##白细胞减少##抑郁症
胎儿异常完全型心内膜垫缺失	完全型心内膜垫缺损
左食指中指撕脱性骨折	指骨骨折
鼻咽左侧壁未分化型非角化性癌治疗中	鼻咽侧壁恶性肿瘤##癌
直肠中下段腺癌	直肠恶性肿瘤##腺癌
葡萄糖－6－磷酸脱氢酶缺陷症	葡萄糖-6-磷酸脱氢酶缺乏性贫血
宫颈鳞癌Ⅲb期化疗后放疗中	子宫颈恶性肿瘤##鳞状细胞癌##化学治疗##恶性肿瘤放疗
颏瘘下颌前牙根尖病变	牙源性面部皮肤瘘管
副蛋白血症性周围神经病变	多发性神经病[多发性神经炎/周围神经炎]##单克隆丙种球蛋白血症
总胆管结石伴慢性胆囊炎	胆总管结石伴慢性胆囊炎
新生儿肺炎黄疸原因待查	新生儿肺炎##新生儿黄疸
左眼急性视网膜坏死综合症	急性视网膜坏死综合征
筛窦癌化疗	筛窦恶性肿瘤##癌
右手指麻木待查腕管综合症	腕管综合征
食管下段恶性肿瘤中医治疗	食管下三分之一的恶性肿瘤##恶性肿瘤中医治疗
四肢肌力下降原因待查格林巴利综合症	肌张力障碍##吉兰-巴雷综合征
系统性硬皮病并雷诺病	系统性硬化症##雷诺综合征
左下肢创伤后不愈创面	开放性损伤愈合不良##下肢开放性损伤
自身免疫性疾病未分型	自身免疫病
妊娠滋养细胞肿瘤第八次化疗	滋养细胞病##化学治疗
前列腺组织伴间质慢性炎	慢性前列腺炎
盆腔粘液性肿瘤	盆腔良性肿瘤##粘液瘤
非甲状腺性变态综合症	甲状腺功能正常的病态综合征
阴道前壁重度膨出达阴道口外后壁中度膨出	阴道前后壁脱垂
盲肠降结肠符合管状腺瘤	盲肠良性肿瘤##降结肠良性肿瘤##管状腺瘤
结肠crohn病	未特指的克罗恩病
骨关节病(平足症)	骨关节病##扁平足
双侧颈动脉内中膜改变伴粥样斑块形成	颈动脉粥样硬化
晚孕头围小	妊娠状态
左下颌下腺腺瘤	颌下腺良性肿瘤##腺瘤
右侧额颞枕顶及纵裂池积液	脑积水
升结肠乳头状管状腺瘤	乳头状管状腺瘤##升结肠良性肿瘤
蓝趾指综合征	蓝趾综合征
胎儿超声异常永久性右脐	永久性右脐静脉
高乳素血症	高泌乳素血症
深静脉血栓形成（左下肢）	下肢深静脉血栓形成
眼眶特指疾患双侧眼眶良性病变	未特指的眼眶疾患
干眼病(结膜干燥)(重度)	结膜干燥症##干眼症
右乳腺肿物切除术后	乳房肿物##乳腺术后
非霍奇金淋巴瘤滤泡向弥漫大B细胞转化	非霍奇金淋巴瘤
中枢神经运动协调障碍	中枢性协调障碍
胃体萎缩Hp治疗后复查	慢性萎缩性胃炎
盆腔粘液性囊性瘤	盆腔良性肿瘤##粘液性囊腺瘤
人工流产伴有组织物滞留	流产
左胫腓骨挫伤	胫骨骨折##腓骨骨折
双眼糖尿病性病变	未特指的糖尿病伴有眼的并发症
肾功能检查的异常结果	肾功能不全
脑内多发缺血性脱髓鞘6双侧上颌窦少量积液	脱髓鞘性脑病##脑血管供血不足
右跟骨部分撕脱性骨折	跟骨骨折
颅内动静脉畸形	头面血管畸形
宫内膜复杂性增生局部轻度非典型性	子宫内膜增生##宫颈上皮不典型增生
肠癌; 喉癌	肠道恶性肿瘤##喉恶性肿瘤##癌
肺Ca合并感染	肺恶性肿瘤##肺部感染##癌
有放疗指征择期放疗	放射治疗
双足坏疽伴感染	下肢坏疽##感染
右肺中叶肺不张	肺不张
高血压性心肌病变	高血压性心脏病
阴道前壁重度膨出后壁中度膨出	阴道前后壁脱垂
多发性淋巴结肿大（淋巴瘤可能性大）	淋巴结肿大##淋巴瘤##淋巴瘤
1.冠心病陈旧前间壁心梗2.高血压3.2型糖尿病	冠状动脉粥样硬化性心脏病##陈旧性前间壁心肌梗死##高血压##2型糖尿病
支气管扩张并感染右肺下叶不张	支气管扩张症合并感染##肺不张
左股动脉支架植入术	周围血管支架植入术后状态
左跟腱陈旧撕裂伴血肿	跟腱损伤
宫颈低级别上皮内病变CINI改变	子宫颈上皮瘤样病变[CIN]I级
肝病血吸虫肝改变可能	血吸虫病##未特指的肝病
肺纤维化肺右侧斜裂纤维硬结	肺纤维化
待查类风湿强脊炎	强直性脊柱炎##类风湿性关节炎
右眼ICE综合症右眼睫状体光凝后	虹膜角膜内皮综合征[ICE综合征]
左乳浸润性癌改良根治术后pT1cN0M0 IA期	乳腺恶性肿瘤##乳腺术后##浸润性导管癌
膝髌下脂肪垫撞击综合征	髌骨后脂肪垫综合征[Hoffa综合征]
左侧颈内动脉血栓形成	颈内动脉血栓形成
子宫内膜不典型息肉样腺肌瘤	子宫腺肌瘤
右月骨开放性脱位并正中神经卡压	正中神经卡压综合征
脐周感染	脐部感染
双足膝内翻	足畸形##膝内翻
鳃裂瘘管术后	鳃裂瘘
左膝皮肤破裂伤	下肢撕裂伤
甲状腺良性滤泡病变	其他特指的甲状腺疾患
右中叶和左上肺下舌段慢性炎症	肺炎
部分小肠切除标本小肠异位胃粘膜和异位胰腺	先天性胃粘膜异位##先天性胰腺异位
腰1腰5陈旧性压缩病变	腰椎压缩性骨折##陈旧性腰椎骨折##腰椎骨折L1##腰椎骨折L5
脑硬变早老性阿尔海茨海默	阿尔茨海默病(老年前期型)
宫颈湿疣阴道湿疣	尖锐湿疣##肛门生殖器疣
双下肢无力待查--腰椎间盘病变	肢体无力##椎间盘疾患
低白细胞血血症低中性粒细胞血症	白细胞减少##中性粒细胞减少症
支气管哮喘继发感染糖尿病高血压病;冠心病	支气管哮喘##感染##糖尿病##高血压##冠状动脉粥样硬化性心脏病
嗅觉缺乏	嗅觉丧失
PBC脾功能亢进	原发性胆汁型肝硬化##脾功能亢进
右肾多发肾结石	肾结石
结肠毛细血管扩张症	胃肠道毛细血管扩张症
心律不齐快速型房颤	心律失常##心房颤动[心房纤颤]
横结肠缺血坏死伴穿孔	缺血性肠坏死##结肠穿孔
胃窦隆起管状腺瘤	胃良性肿瘤##管状腺瘤
膀胱结石取石术后	膀胱结石##膀胱术后
十二指肠乳头低级别绒毛状管状腺瘤	十二指肠良性肿瘤##管状绒毛状腺瘤
"肝癌术后,残余及肝内新生灶,失眠伴焦虑抑郁状态"	肝术后##肝恶性肿瘤##失眠##焦虑状态##抑郁状态##癌
右侧眼眶撞伤	眼和眶未特指的损伤
左侧髂窝囊性占位	骨盆部囊肿
特发性色素性斑	色素沉着未特指的疾患
先天性肠重复畸形	肠重复畸形
膀胱充盈欠佳前列腺略增大	前列腺增生
构音障碍和言语讷吃	构音障碍##言语讷吃
枕叶异常密度影	"颅骨和头诊断性影像检查的异常所见,不可归类在他处者"
电弧烧伤双手	手部烧伤##电流引起烧伤
前庭神经元Hunter综合征	膝状神经节炎
家族性渗出性玻璃体视网膜病变	家族性渗出性玻璃体视网膜病变
白质脑病病因不清中毒可能大	脑白质病##中毒性脑病
降结肠管状腺瘤未带蒂部	管状腺瘤##降结肠良性肿瘤
胃体下部IIa型病灶并内镜粘膜下剥离术	胃和十二指肠未特指的疾病
SLE肺间质病变髋病变	间质性肺病##系统性红斑狼疮
膨胀纹cushing综合症	皮质醇增多症[库欣综合征]
贲门局灶癌变	贲门恶性肿瘤##癌
右肘关节肿块	上肢肿物
肺结节(右肺实性结节，慢性炎症？)	肺占位性病变##肺炎
肉芽肿性唇炎	唇炎
妊娠11+1周，G4P1，甲减，巨大儿分娩史，	孕11周##甲状腺功能减退
耳鸣;分泌性中耳炎;鼻中隔偏曲;慢性咽炎;鼻窦炎;头痛;脑血管供血不足;变应性支气管炎	耳鸣##分泌性中耳炎##鼻中隔偏曲##慢性咽炎##鼻窦炎##头痛##脑血管供血不足##支气管炎
左大腿肉芽肿性炎	肉芽肿
软组织淋巴瘤	软组织恶性肿瘤##淋巴瘤##淋巴瘤
升结肠中分化管状腺癌	升结肠恶性肿瘤##管状腺癌
右胸壁脂肪坏死性肉芽肿性炎	脂肪坏死##肉芽肿
回盲部粘液腺癌术后	回盲部恶性肿瘤##粘液腺癌
原发不孕POF盆腔输卵管因素EMS	原发不孕##卵巢早衰
肉芽肿性肝炎	"肉芽肿性肝炎,不可归类在他处者"
C3~4脊髓损伤	颈部脊髓损伤
卵巢高级别浆液性腺癌	卵巢恶性肿瘤##腺癌
乳癌化疗	乳腺恶性肿瘤##癌##化学治疗
盲肠横结肠管状腺瘤	管状腺瘤##横结肠良性肿瘤##盲肠良性肿瘤
右乳癌综合治疗后肝、骨转移 IV期	乳腺恶性肿瘤##骨继发恶性肿瘤##肝继发恶性肿瘤##癌##转移性癌
右眼急性视网膜坏死	急性视网膜坏死综合征
双膝关节骨关节病	双侧膝关节骨性关节病
双侧豆状核变性萎缩	大脑变性##脑萎缩
右侧舌鳞癌	舌恶性肿瘤##鳞状细胞癌
高血压脑动脉硬化	高血压##动脉硬化
锥体外糸病	锥体外系综合征
慢性淤血性脾肿大伴局部梗死	慢性充血性脾大##脾梗死
右上肺结节：炎症？MT？	肺占位性病变##肺炎##肺恶性肿瘤
肩关节肘关节退行性病变	肩骨关节病##肘骨关节病
完全性肺静脉异位引流——混合型延迟关胸	"完全性肺静脉异位引流,混合型"
右上肺浸润性腺癌（cT2aN2M1bIV期）	右肺上叶恶性肿瘤##腺癌
慢性炎症性脱髓鞘性多发性神经病	慢性炎性脱鞘性多发性神经根神经病[慢性吉兰-巴雷巴利综合征]
波状热流产热	布氏杆菌病[波状热]
不典型帕金森综合征	帕金森综合征
46慢性根尖牙周炎	慢性根尖周炎
左上肢开水烫伤	沸水烫伤##上肢烫伤
感染性发疹?过敏性皮炎？	过敏性皮炎
双侧输卵管伞端阻塞伴输卵管扩张积液	输卵管积水##输卵管梗阻
特指胎盘疾病低置胎盘状态	其他的胎盘疾患##低置胎盘
肝门区胆管癌	肝门胆管恶性肿瘤##癌
走路不稳双手无力原因待查格林巴利综合征	肌无力##吉兰-巴雷综合征
周围神经病(？)	多发性神经病[多发性神经炎/周围神经炎]
骨关节病OA	骨关节病
慢性萎缩性胃炎伴肠化	慢性萎缩性胃炎##肠上皮化生
右半结肠Crohn氏病	结肠克罗恩病
甲亢免疫性甲状腺炎？	甲状腺功能亢进症##自身免疫性甲状腺炎[桥本病]
先天性眼底缺陷双眼失明	先天性眼底缺损##双眼盲
右侧颌下瘢痕	瘢痕
继发性肾病综合症	肾病综合征
COPD肺心病抗病毒治疗免疫功能低	慢性阻塞性肺疾病##肺源性心脏病##抗病毒药的有害效应
胫骨软骨瘤	胫骨良性肿瘤##软骨瘤
左示中指撕脱性骨折	指骨骨折
系统性红斑狼疮狼疮肾炎	系统性红斑狼疮##狼疮性肾炎
结肠癌癌痛	结肠恶性肿瘤##癌##癌性疼痛
左侧阴囊皮肤Paget’s病	阴囊恶性肿瘤##乳房以外的佩吉特病
右肱二头肌肌腱脱位	肌腱滑脱
动脉粥样硬化斑块伴有狭窄	动脉粥样硬化##动脉狭窄
糖尿病并眼部病变	未特指的糖尿病伴有眼的并发症
宫颈鳞状上皮内瘤变II级	宫颈上皮瘤样病变[CIN]II级
腹腔间室综合症	腹腔筋膜室综合征[腹腔室隔综合征ACS]
左回旋支粥样硬化伴重度狭窄	冠状动脉粥样硬化##冠状动脉狭窄
"先天性心脏病：ASD,VSD,PDA"	先天性心脏病##房间隔缺损##室间隔缺损##动脉导管未闭
左面颊部淋巴水瘤	水囊瘤##面部淋巴管瘤
右侧颞叶内侧梗塞急性期多发性腔隙性脑梗塞	多发性脑梗死##腔隙性脑梗死
右腹股沟滤泡性淋巴瘤靶向治疗	滤泡淋巴瘤##恶性肿瘤靶向治疗
颈椎反曲	颈椎后凸
左肺小细胞Ca广泛期	左肺恶性肿瘤##小细胞癌
癫痫脑梗死	癫痫##脑梗死
经前紧张综合征	经前期紧张综合征
腹主动脉股动脉血栓	股动脉血栓形成##腹主动脉血栓形成
胆囊癌并肝转移伴梗阻性黄疸	胆囊恶性肿瘤##癌##梗阻性黄疸##肝继发恶性肿瘤##转移性癌
右心房血管肉瘤	血管肉瘤##心房恶性肿瘤
椎管内硬脊膜血管脂肪榴	椎管内脂肪瘤##血管脂肪瘤
脑动脉痉挛，脑功能失调；睡眠障碍	脑动脉痉挛##睡眠障碍
Barrett's巴莱特食管胃糜烂	巴氏食管##糜烂性胃炎
双乳溢奶液	溢乳
卵巢异常信号影	其他特指身体结构诊断性影像检查的异常所见
右膝后十字韧带损伤	膝关节后十字韧带损伤
胆汁反流性胃炎	反流性胃炎##胆汁反流
糖尿病性自主功能紊乱	糖尿病性自主神经病
脑出血脑干出血破入四脑室及中脑导水管	脑出血##脑干出血
（子宫）子宫内膜样腺癌，中分化；	子宫内膜样腺癌##子宫内膜恶性肿瘤
中高分化腺癌	腺癌
儿保生长发育同同龄儿头围大缺锌	锌缺乏
狼疮肾LN-IVV复发治疗后复诊	狼疮性肾炎
角膜上皮擦伤	角膜擦伤
右侧肺炎伴肺炎旁胸腔积液	肺炎##胸腔积液
脑内多发腔隙灶老年性脑改变	腔隙性脑梗死
冠心病;失眠;慢性喘息性支气管炎	冠状动脉粥样硬化性心脏病##失眠##O
十二指肠壶腹部中低分化腺癌	法特壶腹恶性肿瘤##腺癌
睾丸未发育性腺低功	先天性睾丸发育不良##男性性腺功能低下
甲状腺乳头状癌术后伴双肺转移（TxN1bM1，Ⅳc期，高危）	甲状腺恶性肿瘤##甲状腺术后##甲状腺乳头状癌##肺继发恶性肿瘤##转移性乳头状癌
右耳廓外耳道沸水烫伤	沸水烫伤
右乳外上局限性腺体增厚明显Ca待排	乳腺恶性肿瘤##癌
(肋间神经痛胸膜炎)	肋间神经痛##胸膜炎
右半结肠高中分化腺癌	结肠恶性肿瘤##腺癌
多发颅内动脉狭窄	动脉狭窄
右乳伤口愈合不良	乳房开放性损伤##开放性损伤愈合不良
汽车排气管烫伤2%Ⅲ°右前臂腹部左	上肢烫伤##躯干部烫伤
分叶性肾炎	膜性增殖性肾小球肾炎
右上肺斑片状影陈旧性病灶	肺病##肺部阴影
宫颈高级别上皮内病变CINⅢ级并累及腺体	子宫颈上皮内瘤变III级[CINIII级]
吞咽堵塞感查因贲门迟缓	吞咽障碍##贲门失弛缓
颈肌抽搐查因	不自主运动
外源性皮质功能减退症	其他和未特指的肾上腺皮质功能减退症
胎盘绒毛及蜕膜组织局部可见变性梗死	胎盘梗死
IVF治疗内异位高PRL血症	胚胎移植术后##高泌乳素血症
胃低分化腺癌化疗后	胃恶性肿瘤##腺癌##化学治疗
双肾高密度影较前增多	泌尿器官诊断性影像检查的异常所见
双乳雷诺氏症	雷诺综合征
失眠(神经衰弱)	神经衰弱##失眠
功能性胃肠紊乱	胃肠功能紊乱
老年性精神病认知功能障碍老年性	精神障碍##认知障碍
与人发生冲突时被人用凳子打伤头部	头部损伤
癫痫。运动发育落后	癫痫
颌下腺结石术后	涎石病
多发腰椎压缩性骨折	腰椎压缩性骨折##腰椎多发性骨折
胃体低分化腺癌IV期 肠型 HER2(-) 化疗	胃体恶性肿瘤##腺癌##化学治疗
药物诱导自身免疫性肝炎	自身免疫性肝炎
偏执狂	妄想性障碍
呼碱合并代酸	呼吸性碱中毒##代谢性酸中毒
糙皮病	糙皮病[陪粒格/烟酸缺乏]
耳部恶性肿瘤	恶性肿瘤##耳部肿瘤
肢体截肢术后	截肢
左膝符合游离体以软骨组织为主局部伴骨化	膝关节游离体
双下肢废用性萎缩左足跟压疮	压疮##失用性肌肉萎缩
右侧骶髂关节椎体退行性变	骨关节病##脊椎退行性病变
隐匿性乳腺癌	乳腺恶性肿瘤##癌
右侧睾丸肿瘤术后刀口感染	手术后切口感染##睾丸肿瘤
左下肢肌萎缩	下肢肌肉萎缩
贲门粘液腺癌	贲门恶性肿瘤##粘液腺癌
自发性颅内低压硬膜外自体血注射治疗后	自发性低颅压综合征[原发性低颅压]
左眼白内障	白内障
宫颈癌Ⅱb期化疗后	子宫颈恶性肿瘤##化学治疗##癌
血管免疫母	血管免疫母细胞性淋巴结病
右乳腺浸润性癌术后化疗后靶向治疗（pT2N0M0	乳腺恶性肿瘤##恶性肿瘤术后化疗##恶性肿瘤术后靶向治疗##癌
左侧月骨三角骨缺血坏死	月骨缺血性坏死##骨缺血性坏死
双上腔静脉左上腔静脉异位引流	先天性双上腔静脉
右腮腺低分化癌	腮腺恶性肿瘤##癌
肝脏挫伤术后	肝挫伤##肝术后
胃癌累及食道	胃恶性肿瘤##食管继发恶性肿瘤##癌
直肠癌放化疗后 T3N1M0 IIIB期	直肠恶性肿瘤##癌##恶性肿瘤放疗##化学治疗##淋巴结继发恶性肿瘤
子宫颈上皮内瘤变I-II级	子宫颈上皮瘤样病变[CIN]I级##宫颈上皮瘤样病变[CIN]II级
胃窦多发早期carcinoma	胃窦恶性肿瘤##癌
双膝骨关节炎，双膝滑膜炎，半月板损伤	膝骨关节病##膝关节滑膜炎
中指掌指关节部分脱位	掌指关节脱位
上呼吸道的疾病右下肢无力	肢体无力##未特指的上呼吸道疾病
阻塞性肺癌	肺恶性肿瘤##癌
前臂肌肉扭伤	身体未特指部位的脱位、扭伤和劳损
听力异常	听功能障碍
右股骨骨折术后	股骨骨折##骨折术后
舌疾患裂纹舌	舌未特指的疾病##裂纹舌
右腕部胡蜂蜇伤	蜂螫伤##腕部损伤
下唇疖肿	皮肤疖肿
膝关节疼痛待查游离体	膝关节痛
宫颈上皮内瘤样变III级	子宫颈上皮内瘤变III级[CINIII级]
牙龈创伤	牙及相关组织损伤
左手中指恶性黑素瘤	手指恶性黑色素瘤##恶性黑色素瘤
阴道炎(阴道假丝酵母菌病)	念珠菌性阴道炎
膝关节腘窝囊肿	膝关节囊肿##腘窝囊肿
甲状腺全叶乳头状癌	甲状腺恶性肿瘤##甲状腺乳头状癌
右肾囊性占位	肾囊肿
牙挫伤	牙及相关组织损伤
移植供肾纤维化较严重	肾移植状态
慢支炎，肺气肿	慢性支气管炎##肺气肿
L3椎体骨破坏待查并截瘫	骨质破坏##截瘫[双下肢瘫痪]
颈动脉椎基动脉及脑动脉粥样硬	颈动脉粥样硬化
膀胱腺癌	膀胱恶性肿瘤##腺癌
耳廓肿物（纤维瘤）	耳廓肿物##耳廓良性肿瘤##纤维瘤
2.颈部硬膜外出血	硬膜外出血
血液粘滞	高粘滞综合征
双手无力查因平山病	肌无力##青年上肢远端肌萎缩症[平山病]
左侧听力损害	听功能障碍
糖尿病痛性神经病变	糖尿病
双腿僵手麻浮肿	局部水肿
肾上腺肿物腺瘤可能	肾上腺肿物##腺瘤##肾上腺良性肿瘤
停经243周B超提示胎儿右肾未显影	妊娠状态
妊娠瘙痒性荨麻疹性丘疹斑块	妊娠合并瘙痒性荨麻疹性丘疹
右肾造瘘术后	肾造口状态
左肺肺炎	肺炎
鼻部面部多处抓伤	鼻部开放性损伤##面部开放性损伤
原发性支气管肺癌(左肺腺癌 cT3N1M1a(胸膜) IVA期 EGFR野生型 HER-2(E20第771-774杂合性	左肺恶性肿瘤##腺癌##胸膜继发恶性肿瘤
膀胱浸润性高级别乳头状尿路上皮癌	膀胱恶性肿瘤##乳头状尿路上皮癌
膀胱微乳头型尿路上皮癌	膀胱恶性肿瘤##乳头状尿路上皮癌
晚孕胎儿四肢低于正常	妊娠状态##胎儿肢体畸形
高分化脂肪肉瘤	脂肪肉瘤
妊娠期糖尿病G4P1孕39+4周待产LOA	妊娠期糖尿病##孕39周
双眼人工晶体植入术	人工晶体植入状态
肝部继发性恶性肿瘤	肝继发恶性肿瘤
右上肺腺癌综合治疗后	右肺上叶恶性肿瘤##腺癌
慢性移植物抗宿主反应病肝脏皮肤口腔	慢性移植物抗宿主病
头胀待查TIA	短暂性脑缺血发作
疤痕子宫腹腔镜下子宫腺肌症切除术	瘢痕子宫##子宫肌腺症##子宫术后
右上肢被玻璃划伤	上肢开放性损伤##玻璃割伤
"鼻咽黑色素瘤术后,肠镜肠道准备"	鼻咽术后##鼻咽恶性肿瘤##黑色素瘤
胃窦溃疡型低分化腺癌伴印戒细胞癌成分	胃窦恶性肿瘤##腺癌##印戒细胞癌
子宫内膜消融术后	子宫术后
急性无黄疸型戊肝	病毒性肝炎戊型急性无黄疸型
原发性高血压III级	原发性高血压##高血压3级
妊娠性心脏改变	循环系统疾病并发于妊娠、分娩和产褥期
咳嗽晕厥	咳嗽晕厥综合征
右臀部及右侧骶髂关节病变原因结核性	骶髂关节结核##臀部结核
右输尿管结石伴肾积水	肾积水伴输尿管结石
左肺上叶支气管病变伴左上肺阻塞性病变	"慢性阻塞性肺疾病##支气管疾病,不可归类在他处者"
腹痛胆石症胆囊炎	胆囊炎##腹痛##胆石症
髂腰韧带劳损	腰椎和骨盆其他和未特指部位的扭伤和劳损
停经326周B超提示胎儿脾脏囊性回声	妊娠状态
L2椎体压缩性骨折	腰椎压缩性骨折
两个手指离断伤	仅两个或更多手指创伤性切断(完全)(部分)
颈髓空洞症肘关节病变	脊髓空洞症
成人STILLS病	成年型斯蒂尔病[Still病]
脊髓恶性压迫并截瘫	脊髓压迫症##未特指的截瘫
糖尿病低血糖;糖尿病视网膜病变;高脂血症	糖尿病性低血糖症##糖尿病性视网膜病变##高脂血症
口咽癌综合治疗后	口咽恶性肿瘤##癌
特指胎盘疾病低置胎盘胎盘浅植入	其他的胎盘疾患##低置胎盘##胎盘植入不伴出血
小肠系膜病变	腹膜未特指的疾患
残胃CA	残胃恶性肿瘤##癌
睑(缘)炎	睑缘炎
前列腺增生症术后	前列腺增生##前列腺术后
多发性骨纤维发育反复不良伴性早熟综合征	多发性骨纤维发育不良伴性早熟综合征[Albright综合征]
乙状结肠溃疡型中分化腺癌pT4aN0M0 IIB期根治术后	结肠术后##乙状结肠恶性肿瘤##腺癌
新生儿缺氧缺血性脑病并颅内出血	新生儿缺氧缺血性脑病##颅内出血
非霍奇金氏淋巴瘤(弥漫大B细胞型（ABC型） Ⅱ期B组)	非霍奇金淋巴瘤##弥漫大B细胞淋巴瘤
胎盘疾病胎膜残留	胎膜部分残留不伴出血##未特指的胎盘疾患
T3椎体骨质破坏并脊髓压迫	骨质破坏##脊髓压迫症
尿道下裂	尿道下裂
右中叶支气管粘膜白斑样病变	"白斑病,不可归类在他处者"
面部双手双下肢色素沉着待查	皮肤色素沉着
鞍区肿瘤放疗后	脑恶性肿瘤##恶性肿瘤放疗
小肠炎症性肠病	炎症性肠病
皮肤色素斑	色素斑
胃癌维持性化疗	胃恶性肿瘤##恶性肿瘤维持性化学治疗##癌
乳腺Caa化疗	乳腺恶性肿瘤##癌##化学治疗
右上肢肱二头肌部分断裂	肱二头肌肌肉和肌腱损伤
双颊及下唇扁平苔藓免疫异常	口腔扁平苔癣##扁平苔癣
双眼屈光不正；黄斑病变；双眼糖尿病眼底病变	屈光不正##O##糖尿病性视网膜病变
右肩胛骨4期压疮截肢残端多处3期压疮	截肢
结膜炎行动不便	结膜炎
肿瘤(?)	性质未特指的肿瘤
胼胝体发育异常	胼胝体发育不全
右胸壁肿瘤术后	胸壁肿瘤
左手麻木待查脑缺血及萎缩	脑血管供血不足##脑萎缩
腰背部劳损	腰部劳损##背部劳损
言语不能右肢无力待查	言语障碍##偏侧肢体无力
肺癌复发	肺恶性肿瘤##癌##恶性肿瘤复发
乳腺多处恶性肿瘤	乳腺恶性肿瘤
肝郁犯胃痰气郁结咽异症	咽异感症
肾癌 尿路感染	肾恶性肿瘤##泌尿系感染##癌
脑白质缺血脱髓鞘病变	脑血管供血不足##脱髓鞘性白质脑病
颈5椎体骨折	颈椎骨折C5
甲状腺滤泡性腺瘤伴出血囊性变	甲状腺良性肿瘤##滤泡性腺瘤
低钠低氯血症	低钠血症##低氯血症
病理诊断1左颈鳃裂瘘管符合鳃裂瘘管改变	鳃裂瘘
输卵管未分化低分化癌	输卵管恶性肿瘤##未分化的癌
直肠中上段腺癌	直肠恶性肿瘤##腺癌
大便性状改变原因1肠易激综合症2其他	肠易激综合征##其他大便异常
发热、皮下结节待查，自身炎症性疾病？	发热##皮下结节
扁平苔藓乳房Paget	扁平苔癣##乳房佩吉特病##乳腺恶性肿瘤
非霍奇金淋巴瘤 滤泡性淋巴瘤 3A级 Ⅳ期 A组（累及双锁骨上窝、双腋窝、纵隔心膈角区、腹膜后、盆腔、双腹股沟）ECOG评分3分 A组FLIPI-1 5分 FLIPI-2 3分	非霍奇金淋巴瘤##滤泡淋巴瘤##锁骨上继发恶性肿瘤##腋下继发恶性肿瘤##纵隔继发恶性肿瘤##腹膜后继发恶性肿瘤##盆腔继发恶性肿瘤##腹股沟继发恶性肿瘤##转移性肿瘤
"腰痛,腰椎骨性关节炎,行动不便"	腰痛##脊柱骨关节病
脐内皮肤黑色素沉着	其他黑色素沉着过度
停经35周MR提示胎儿后颅窝池扩大	孕35周
口咽癌姑息	口咽恶性肿瘤##姑息医疗##癌
右股骨骨折术后1年余无畸形无发热	股骨骨折##骨折术后
左颈动脉硬化性狭窄	颈动脉硬化##颈动脉狭窄
中高分化子宫内膜样腺癌	子宫内膜样腺癌##子宫内膜恶性肿瘤
腰椎侧凸变形	腰椎侧弯
直肠憩室炎	憩室炎
全身多处转移性骨肿瘤	骨继发恶性肿瘤##转移性肿瘤
泪道激光成形术后	眼术后
左手鸟养伤	"被其他哺乳动物咬伤或抓伤,在未特指场所##手部损伤"
左腕关综合症	腕管综合征
食管和贲门恶性肿瘤	食管恶性肿瘤##贲门恶性肿瘤
电解质代谢紊乱低钾低钠低氯血症	电解质紊乱##低钠血症##低钾血症##低氯血症
足趾麻木原因待查周围神经病其他	多发性神经病[多发性神经炎/周围神经炎]
慢性浅表性胃炎并糜烂	慢性浅表性胃炎##糜烂性胃炎
阴茎癌伴感染	阴茎恶性肿瘤##感染##癌
左肺尖气肿纤维灶	肺诊断性影像异常##肺气肿
右侧鼻腔恶性黑色素瘤	鼻腔恶性肿瘤##黑色素瘤
三尖瓣疾病	未特指的三尖瓣疾病
霍奇金淋巴结结节硬化型化疗后IIB	结节性硬化型霍奇金病##化学治疗
胸腹主动脉动脉瘤	胸腹主动脉瘤
左上纵隔癌结合形态及免疫表型考虑	纵隔恶性肿瘤##癌
右前降支心肌桥	冠状动脉肌桥
右足烧伤后并趾畸形	足部烧伤##足畸形
牙槽肿物	口腔和咽喉部占位
右侧输卵管异位妊娠	输卵管妊娠
双乳多发纤维腺瘤可能	乳腺良性肿瘤##纤维腺瘤
低钠低氯原因待查1继发性肾上腺皮质功?	低钠血症##低氯血症
结肠毛细管血管扩张症	胃肠道毛细血管扩张症
L45椎间盘膨出中医诊断痹病风寒湿痹证	腰椎间盘移位
左手麻木待查-腕管综合症可能性大	腕管综合征
低鼻畸形	鞍鼻
"胃角癌,"	胃恶性肿瘤##癌
停经354周MR提示胎儿空肠下段闭锁	妊娠状态##先天性空肠闭锁
重度骨质疏松绝经后	绝经后骨质疏松##重度骨质疏松
右侧卵巢囊性成熟型畸胎瘤	成熟型囊性畸胎瘤##卵巢良性肿瘤
左乳腺癌（ST2N1MO）化疗	乳腺恶性肿瘤##癌##化学治疗
Ebstein畸形术后	埃布斯坦畸形[Ebstein畸形]
甲状旁腺腺瘤	甲状旁腺良性肿瘤##腺瘤
子宫妊娠	妊娠状态
胎儿生长发育受限刘鹤莺	妊娠状态
转移性乳腺癌	乳腺继发恶性肿瘤##转移性癌
椎基底动脉系统TIA单纯性髙胆固醇血症	短暂性脑缺血发作##高胆固醇血症
绝经前后诸症手麻手痒眼干	干眼症
F2脐动脉舒张末期血流间歇性缺失	脐血流异常
血铅高钙不足	低钙血症##铅中毒
糖尿病性胃肠神经病变	未特指的糖尿病伴有神经的并发症
人工心脏瓣膜移植状态	具有其他心脏瓣膜置换
右骨盆肿物	骨盆部占位
腹股沟部挫伤	腹股沟区挫伤
Ⅳ期褥疮	受压区Ⅳ期褥疮
"并发性白内障ou,玻璃体混浊ou"	白内障##玻璃体混浊
晚孕IVF胎儿左心偏小	妊娠状态
宫颈高中分化鳞状细胞癌	子宫颈恶性肿瘤##鳞状细胞癌
胃粘膜高级别管状腺瘤	胃良性肿瘤##管状腺瘤
胃底部粘附性癌	胃底恶性肿瘤##癌
贫血原因待查；早孕	贫血##妊娠状态
甲亢并双侧甲状腺肿物	甲状腺功能亢进症##甲状腺肿物
肺癌广泛期	肺恶性肿瘤##癌
大肠多发性腺瘤性息肉	腺瘤样息肉##大肠息肉
臀部软组织尤文肉瘤	臀部恶性肿瘤##尤因肉瘤
完全性肺静脉异位引流心下型无梗阻	"完全性肺静脉异位引流,心下型"
"结肠癌,呃逆,焦虑抑郁状态"	结肠恶性肿瘤##呃逆##癌##焦虑状态##抑郁状态
右乳见导管扩张伴导管上皮乳头状增生	乳腺导管扩张症
右上肢猫抓伤口腔动物致伤	上肢损伤
面部皮肤乳头状肿瘤	乳头状瘤##面部皮肤良性肿瘤
双髋关节DDH继发OA左侧重	先天性髋关节发育不良##双侧髋关节骨性关节病
新生儿肝胆红素血症	新生儿高胆红素血症
左颈慢性肉芽肿性炎	肉芽肿
热液烫伤左足腹部6%TBSAⅡ-Ⅲ°	足部烫伤##躯干部烫伤
3胸腹部肿瘤	胸部肿瘤##腹部肿瘤
上感/急支	上呼吸道感染##急性支气管炎
肝癌晚期	肝恶性肿瘤##癌
高铅血症铁低	铅中毒##铁缺乏
乳腺癌肝转移	乳腺恶性肿瘤##癌##肝继发恶性肿瘤##转移性癌
鼻部皮肤裂伤	鼻部开放性损伤
双侧乳腺增生并结节形成	乳腺增生##乳房结节
多发淋巴组织增生性疾病不除外恶性可能	淋巴组织增生
胎盘绒毛充血局部血肿形成	未特指的胎盘疾患
胎儿肺动脉吊带可能胎儿肾盂分离	肺动脉吊带[先天性迷走左肺动脉]
右内踝及距骨内侧骨软骨缺损伴游离体形成	踝关节内游离体
胃癌(伴转移)	胃恶性肿瘤##癌
发作性右侧面部麻木伴右上肢活动不利待查	运动障碍
踝关节腱鞘囊肿，腱鞘炎	踝关节囊肿##腱鞘囊肿##腱鞘炎
冠脉多支病变中-重度狭窄	冠状动脉狭窄
右臀肌扭伤	身体未特指部位的脱位、扭伤和劳损
人工股骨头置换术后断裂	人工股骨头置换术后假体功能障碍
小肠病变性质待查十二指肠病变性质待查	胃和十二指肠未特指的疾病##肠未特指的疾病
卵巢浆液性腺癌IIIC期术后第四次化疗后	卵巢恶性肿瘤##浆液性腺癌##恶性肿瘤术后化疗
腰45轻度不稳伴轻度退变	腰椎不稳定##腰椎退行性病变
前列腺癌复发	前列腺恶性肿瘤##癌##恶性肿瘤复发
急性脑梗死右侧额叶岛叶室旁多发急性梗塞	脑梗死##多发性脑梗死
直肠上段腺瘤伴高级别上皮内瘤变	直肠良性肿瘤##腺瘤
左颈Castlemen病	Castleman病
上颌窦粘膜下囊肿	上颌窦囊肿
鼻咽右侧壁高分化粘液表皮样癌	鼻咽侧壁恶性肿瘤##粘液表皮样癌
中重度肺高压	中度肺动脉高压##重度肺动脉高压
末端回肠回盲部升结肠横结肠慢性炎症伴溃疡	慢性结肠炎##结肠溃疡
肝右叶巨大HCC	肝细胞癌
右乳肿物纤维腺瘤	乳房肿物##纤维腺瘤##乳腺良性肿瘤
用凳子拳头打伤头面肩背部及四肢	被别人殴打、踢、拧、咬或抓伤##多处损伤
右小腿创伤性软组织缺损皮肤和软组织缺损	"下肢皮肤缺损##下肢未特指的损伤,水平未特指"
喉部气管异物	喉内异物##气管内异物
鼻咽分化型非角化癌	鼻咽恶性肿瘤##癌
胰腺内分泌癌	内分泌胰腺恶性肿瘤##癌
左肺腺癌（T2N3M1B IV期）	左肺恶性肿瘤##腺癌##淋巴结继发恶性肿瘤
cGVHD广泛期眼睛口腔肺脏肝脏皮肤	慢性移植物抗宿主病
颈6椎撕脱性骨折	颈椎骨折C6
右肺占位-肺癌可能性大	肺占位性病变##右肺恶性肿瘤##癌
右侧腹股沟区疼痛	疼痛
卵巢交界瘤术后复查	卵巢交界性肿瘤##卵巢术后
分裂胰腺胰腺狭窄	胰腺分裂症
陈旧性外侧半月板紊乱	膝外侧半月板紊乱
距肛门30cm结肠管状腺瘤低级别	结肠良性肿瘤##管状腺瘤
名称子宫下段剖宫产术	无指征剖宫产的单胎分娩
"右乳癌术后,肺转移切除术后"	乳腺术后##乳腺恶性肿瘤##癌##肺继发恶性肿瘤##肺术后##转移性癌
右踝距骨舟骨跖骨异常型号骨梗死可能	骨坏死
肩背部脂肪增生症	肩部脂肪增多症##背部脂肪增多症
右腹膜后神经母细胞瘤Ⅳ期术后化疗（高危组）	腹膜后恶性肿瘤##神经母细胞瘤##恶性肿瘤术后化疗
慢性功能不全心功能III-IV级	心功能不全##心功能III级(NYHA分级)##心功能IV级(NYHA分级)
双侧肾盂输尿管积液	肾积水##输尿管积水
左甲癌	甲状腺恶性肿瘤##癌
盆底功能障碍性疾病阴道穹隆膨出Ⅳ度	阴道脱垂##盆底功能障碍
冠心病急性广泛前壁ST段抬高型心肌梗死单支病变累及LADLADPCI术后心功能I级（Killip分级）	冠状动脉粥样硬化性心脏病##急性ST段抬高型心肌梗死##KillipI级##PCI术后
干燥综合征继发间质性肺病	干燥综合征[舍格伦综合征]##间质性肺病
肛管直肠腺癌放化疗后	肛管恶性肿瘤##直肠恶性肿瘤##腺癌##恶性肿瘤放疗##化学治疗
右侧股骨头骨骺病	股骨头幼年型骨软骨病[Legg-Calve-Perthes病]
肩痹;咳嗽	咳嗽
右肺癌化放疗后	右肺恶性肿瘤##化学治疗##恶性肿瘤放疗##癌
左膝交叉韧带断裂术后	膝关节十字韧带断裂
肺炎肺癌复诊	肺炎##肺恶性肿瘤##癌
多脏器功能障碍衰竭ARDS肾血液心脏胃肠	急性呼吸窘迫综合征##多脏器功能衰竭
股二头肌半膜肌半腱肌腓肠肌比目鱼肌断裂	腓肠肌断裂##下肢肌肉肌腱断裂
右腹膜后鳞状细胞癌	腹膜后恶性肿瘤##鳞状细胞癌
"左肺腺癌,化疗后白细胞减少IV度,血小板减少"	左肺恶性肿瘤##白细胞减少##血小板减少##化疗药物反应##腺癌
骶棘肌拉伤	躯干肌肉和肌腱损伤
淤积性湿疹并感染	湿疹##感染
房性心律失常，ＰＡＦ	其他特指的心律失常##阵发性心房颤动
食管胃静脉曲张	胃静脉曲张##食管静脉曲张
移植肾肾病	肾移植状态##肾病
新生儿脓疮病	新生儿脓胞疮[新生儿脓疱病]
先天性左侧上睑下垂	上睑下垂
甲状腺功能亢进桥本氏甲亢可能性大	慢性淋巴细胞性甲状腺炎##甲状腺功能亢进症
急性弥漫性血管内凝血障碍	凝血功能障碍##弥散性血管内凝血
胎儿巨膀胱后尿道闭锁不除外	先天性尿道闭锁
面部皮肤赘生物	皮赘
结肠管状腺瘤2结肠管状腺瘤	结肠良性肿瘤##管状腺瘤
5甲状腺功能减低症放射性碘治疗后	碘性甲状腺功能减退
头皮血管畸形	头皮血管畸形
原发性肝癌术后（左肝）	肝术后##肝恶性肿瘤##癌
横结肠双腔造瘘术后	结肠造口状态
右手掌离断	手掌开放性损伤
口周麻木	口周皮肤麻木
鼻窦乳头状瘤术后复发	鼻窦良性肿瘤##乳头状瘤
鼻窦疾病待查	鼻和鼻窦其他特指的疾患
特指再生障碍性贫血	其他特指的再生障碍性贫血
肝曲横结肠管状腺瘤低级别局灶高级别	管状腺瘤##结肠肝曲良性肿瘤
胃肿瘤化疗	胃恶性肿瘤##化学治疗
非霍奇金弥漫性大B细胞淋巴瘤III期A	非霍奇金淋巴瘤##弥漫大B细胞淋巴瘤
直肠侧生型腺瘤	直肠良性肿瘤##腺瘤
左乳腺溢血待查	乳头溢液
右胸下部肋骨处外伤后疼痛3天待查	胸部损伤##骨痛
右手拇指化脓性指头炎	指头炎
右腕舟骨陈旧性骨不连	舟骨骨折不连接
宫颈环形电切术后	宫颈术后
"多发骨转移癌伴重度疼痛,免疫力低下"	骨继发恶性肿瘤##疼痛##癌性疼痛##转移性肿瘤
头颈外斜待查	斜颈
右膝重度OA左膝OA重度OP	双侧膝关节骨性关节病##重度骨质疏松
右额颞部颅骨骨折	颅骨多发性骨折
胃窦腺癌	胃窦恶性肿瘤##腺癌
8胸腔气肿纵隔积气	纵隔气肿##气胸
颈椎椎间盘膨出	其他的颈椎间盘移位
右肾结节查因错构瘤	肾错构瘤##肾占位性病变
病毒性肝炎慢性丙型	慢性丙型病毒性肝炎
胸椎TBCa	胸椎结核##胸椎恶性肿瘤
骨盆骨异常信号影	其他特指身体结构诊断性影像检查的异常所见
右下肺鳞癌	右肺下叶恶性肿瘤##鳞状细胞癌
腹胀痛	腹胀##腹痛
右眼睑皮肤过敏	眼睑变应性皮炎
右上肺腺癌Ⅳ期	右肺上叶恶性肿瘤##腺癌
右侧胫前动脉中下段左侧胫后动脉不全闭塞	胫前动脉闭塞##胫后动脉闭塞
右臂皮肤纤维组织细胞瘤	上肢皮肤良性肿瘤##纤维组织细胞瘤
右手指骨折	指骨骨折
右脚距骨骨裂	距骨骨折
多发蝴蝶椎	"脊柱其他先天性畸形,与脊柱侧弯无关"
直肠高-中分化腺癌术后	直肠术后##直肠恶性肿瘤##腺癌
足动静脉畸形	先天性动静脉畸形
坐骨神经痛反流行食管炎	坐骨神经痛##反流性食管炎
颅面骨发育不全	颅面骨发育不全
新高儿胆红素血症病理性	新生儿高胆红素血症
放射碘后胫前病变眼病	放射性损害
"上呼吸道感染口腔溃疡,行动不便,关节痛,反酸痛风,冠心病预防血栓,高血压"	上呼吸道感染##口腔黏膜溃疡##关节痛##反酸##痛风##冠状动脉粥样硬化性心脏病##高血压
支气管扩张并感染咳血、失眠症	支气管扩张症合并感染##支气管扩张症伴咯血##失眠
铁低取药	铁缺乏
经腹子宫下段剖宫产术签名	经未特指的剖宫产术分娩
脾肾不足疖肿肾气不足	皮肤疖肿
急性百草枯中毒并多脏器功能障碍	多脏器功能障碍综合征[MODS]##农药中毒
1妊4产2妊356周LSA剖宫产单臀	无指征剖宫产的单胎分娩
进展期胃癌IV期	胃恶性肿瘤##癌
坐骨神经疾患	坐骨神经损害
中位心	中位心
符合慢性溶血性脾肿大	脾大
前列腺滤泡腺癌放疗后	前列腺恶性肿瘤##腺癌##恶性肿瘤放疗
咽侧感染	感染
左束支传导组织阻滞	左束支传导阻滞
左侧颞顶枕部硬膜血肿机化	血肿机化
中枢性性早熟单纯乳早发育	中枢性性早熟
右肾实质性结节错构瘤	肾错构瘤
鼻咽恶性黑色素瘤治疗后	鼻咽恶性肿瘤##恶性黑色素瘤
宫颈上皮内瘤样病变II-III级	子宫颈上皮内瘤变III级[CINIII级]##宫颈上皮瘤样病变[CIN]II级
胫骨平台骨折术后	胫骨平台骨折##骨折术后
皮质下脑病	未特指的脑病
多发脑腔隙灶右脉络膜裂小囊肿	脉络膜破裂##腔隙性脑梗死##颅内囊肿
包茎球囊扩张术后换药	包茎##阴茎术后
颅内多发陈旧性腔腺性梗塞	腔隙性脑梗死##多发性脑梗死##陈旧性脑梗死
右侧声门区中分化鳞状细胞癌	声门恶性肿瘤##鳞状细胞癌
左右侧颈动脉软斑及右侧锁骨下动脉混合斑	锁骨下动脉斑块
双下肢活动受限原因失用性肌萎缩	失用性肌肉萎缩##运动障碍
股骨远端内生软骨瘤	软骨瘤病
回盲部溃疡型中分化腺癌	回盲部恶性肿瘤##腺癌
双眼后巩膜加固术后	眼术后
手足廯	手癣##足癣
糖尿病性肾病CKD4期	"糖尿病性肾病##慢性肾脏病,4期"
腰痛(泌尿系统结石?)	腰痛##泌尿系结石
溃结全大肠重度活动期	溃疡性结肠炎
双眼角膜病变8前列腺肥大	角膜未特指的疾患##前列腺增生
乳癌晚期	乳腺恶性肿瘤##癌
功能性吞咽不畅	吞咽困难
额骨多发粉碎性塌陷性骨折	额骨骨折
泌乳素型垂体腺瘤	垂体腺瘤##垂体良性肿瘤
食欲缺乏心衰胃肠道淤血引起可能	食欲缺乏##心力衰竭
子宫黏膜下肌瘤	子宫粘膜下平滑肌瘤##子宫平滑肌瘤
小网膜、胃壁多发淋巴结转移	淋巴结继发恶性肿瘤
咽旁间隙及鼻咽血管瘤术后	鼻咽血管瘤##鼻咽术后
右眼睑过敏	眼睑变应性皮炎
慢性酒精中毒性脑病，脑梗塞	酒精中毒性脑病##脑梗死
右肾肾小球广泛玻璃样变性	肾小球病
尿路感染，肾炎？左肾静脉受压？	泌尿系感染##肾炎##左肾静脉压迫综合征[胡桃夹现象]
前列腺增生切除术后	前列腺增生##前列腺术后
宫颈癌术后放疗后复发	子宫颈恶性肿瘤##癌##恶性肿瘤术后放疗##恶性肿瘤复发
左腿软组织裂伤	"下肢未特指的损伤,水平未特指"
直肠癌术后4年，确诊为复发放疗中	直肠术后##直肠恶性肿瘤##放射治疗##恶性肿瘤复发##癌
移植肾动脉破裂	肾移植状态
下咽后壁乳头状瘤	乳头状瘤##咽良性肿瘤
皮内型色素痣	皮内痣
乙状结肠癌术后，，淋巴结转移，，呕吐，化疗肠镜检查	结肠术后##乙状结肠恶性肿瘤##癌##淋巴结继发恶性肿瘤##呕吐##化学治疗
右室心尖部局限性膨隆心室憩室	先天性右心室憩室
急性下壁ST段抬高型心肌梗死	急性下壁心肌梗死##急性ST段抬高型心肌梗死
创伤性硬脑膜下出肿伴开放性颅内伤口	颅脑开放性损伤伴颅内损伤##创伤性硬脑膜下血肿
感冒/霉菌性皮炎/气管炎	感冒##真菌性皮炎##气管炎
停经236周B超提示胎儿永久性右脐静脉	妊娠状态##永久性右脐静脉
左腮腺外耳道病变左颞骨病变左颞颌关节	外耳未特指的疾患##骨病变
右侧小指电灼伤	手指损伤##电流引起烧伤
肺炎在感染	肺炎##肺部感染
颅内多发缺血及腔隙性梗死	腔隙性脑梗死
右拇指肌腱损伤	腕和手肌肉和肌腱损伤
双侧大脑半球继发恶性肿瘤	脑继发恶性肿瘤
左输尿管中段结石伴左肾积水感染	输尿管结石##肾积水##肾感染
脑白质深部多发缺血脱髓鞘改变	脱髓鞘性白质脑病##脑血管供血不足
电解质功能紊乱低钾低钙	电解质紊乱##低钾血症##低钙血症
1先天性新生儿皮肤缺损	先天性皮肤缺失
双侧副舟骨源性平足症	先天性足副舟骨##扁平足
慢性肺部疾病合并肺心病	肺病##肺源性心脏病
胃功能异常AFP升高	胃肠功能紊乱##甲胎蛋白异常
左肺SCLC局限期3程化疗后	肺恶性肿瘤##小细胞癌##化学治疗
食管高分化鳞状细胞癌	食管恶性肿瘤##鳞状细胞癌
双侧放射性肺炎并感染	放射性肺炎##肺部感染
双眼视网膜脉络膜病变	分类于他处的疾病引起的脉络膜视网膜疾患
痢疾复查	未特指的细菌性痢疾
右胫骨骨外露骨不连	胫骨骨折不连接
双侧上颌牙列部分缺失骨量不足	牙列缺失
十二指肠钩虫症	十二指肠钩虫病
左足背砸伤软组织损伤	足部损伤##砸伤
双侧颊部及下颌牙龈扁平苔藓免疫异常	口腔扁平苔癣##扁平苔癣
脑梗塞关节炎抑郁症支气管炎	脑梗死##关节炎##支气管炎##抑郁症
(降结肠)腺瘤性息肉	降结肠息肉##腺瘤样息肉
左肺上叶磨玻璃待查	肺诊断性影像异常
"胃癌,肝转移,骨转移,肝功异常"	胃恶性肿瘤##癌##肝继发恶性肿瘤##骨继发恶性肿瘤##转移性癌##肝功能异常
直肠肛门口绒毛管状腺瘤	直肠良性肿瘤##肛门良性肿瘤##管状绒毛状腺瘤
右肺癌术后 双肺多发转移 脑转移	肺术后##右肺恶性肿瘤##肺继发恶性肿瘤##脑继发恶性肿瘤##转移性癌
"胃癌全切术后,恶性腹腔积液"	胃术后##胃恶性肿瘤##癌##恶性腹腔积液
"胰腺结节待查,食管癌术后"	胰腺占位性病变##食管术后##食管恶性肿瘤##癌
双下肢麻烦待查OA	骨关节病
内侧半月板撕裂	膝内侧半月板撕裂
原发中枢神经系统恶性淋巴综合治疗后	淋巴瘤
手外伤右手环指	手指损伤
卵巢癌个人史	卵巢恶性肿瘤史##癌
左颈内动脉动脉瘤	颈内动脉瘤
烧、烫伤(急)	烧伤##其他烫伤
主动脉夹层(III型)	主动脉夹层B型
右侧听神经瘤	听神经良性肿瘤##听神经瘤
距肛门50cm管状腺瘤低级别	管状腺瘤##结肠良性肿瘤
获得性依赖维生素K凝血因子异常症	获得性维生素K依赖因子缺乏症
双膝弹响	弹响膝
双肺胸膜下微小结节	肺占位性病变##胸膜占位
胫骨骨样骨瘤	胫骨良性肿瘤##骨样骨瘤
双肾发育异常	先天性肾发育不良
神经源性晕厥	晕厥
结肠中分化腺癌术后	结肠恶性肿瘤##腺癌##结肠术后
慢性肺曲菌病	肺曲霉菌病
左肘左膝左足部工伤	"上肢损伤##足部损伤##下肢未特指的损伤,水平未特指"
左房轻度扩大升主动脉轻度增宽左室假腱索	心室假腱索
先天性喉软骨发育不良(轻度)	先天性喉发育不全
食欲不振咽部梗阻感	食欲不振##吞咽困难
左膝股骨外髁大面积骨软骨剥脱伴游离体形成	膝关节骨软骨炎##膝关节游离体
右乳导管内乳头状瘤可能	导管内乳头状瘤##乳腺良性肿瘤
右附件区囊性回声输卵管积液待排	输卵管积水
慢性弥漫性肝疾患	未特指的肝病
双肾多发囊肿伴囊内结石	肾囊肿
"胃肠炎,口腔阿弗他溃疡"	胃肠炎##口腔黏膜溃疡
慢性肾脏病矿物质和骨代谢异常	慢性肾病##矿物质代谢紊乱
右眼黄斑裂口	黄斑裂孔
"高血压病,冠心病，慢性肝炎"	高血压##冠状动脉粥样硬化性心脏病##慢性肝炎
指甲髌骨综合症	指甲髌骨综合征
慢性肾脏疾病CKD5级	"慢性肾脏病,5期"
双肾错构瘤可能	肾错构瘤
口腔颊黏膜舌覆扁平苔藓免疫异常	口腔扁平苔癣##舌扁平苔癣
左乳癌术后锁骨上淋巴结复发	乳腺术后##乳腺恶性肿瘤##锁骨上淋巴结继发恶性肿瘤##癌
左足内侧楔骨骰骨撕脱性骨折	足楔状骨骨折##骰骨骨折
左胫腓骨骨挫伤	小腿骨折
无骨折脱位型颈脊髓损伤伴四肢全瘫	颈部脊髓损伤##四肢瘫
抽搐查因继发性癫痫	抽搐状态##症状性癫痫[继发性癫痫]
右下肺中心型小细胞肺癌	右肺下叶恶性肿瘤##小细胞癌
胆石症伴慢性胆囊炎	胆石症##慢性胆囊炎
右扁桃体隐窝赘生物	扁桃体息肉
恶性肿瘤未特指	部位未特指的恶性肿瘤
食积气滞脾胃不和咽炎痹症	咽炎
3右眼网膜脉络膜病变	脉络膜未特指的疾患##视网膜未特指的疾患
心功能Ⅲ级2卵圆孔未闭	心功能III级(NYHA分级)##卵圆孔未闭
回盲部病变并狭窄	肠未特指的疾病##肠狭窄
第3腰椎横突骨折	腰椎压缩性骨折##腰椎骨折L3
心脾肺虚血脂高	高脂血症
ECG:窦性心律；非特异性T波异常	心电图异常
L5双侧椎弓峡部不连并椎体不稳	腰椎峡部裂##腰椎不稳定
直肠乙状结肠双原发癌	直肠恶性肿瘤##乙状结肠恶性肿瘤##癌
第1趾末节部分缺血性坏死右足血供不足	下肢供血不足##足坏死
多发骨M原发不明	骨继发恶性肿瘤##转移性肿瘤
瘾疹燥灼痒甚下肢麻	瘙痒症
十二指肠腺瘤	十二指肠良性肿瘤##腺瘤
右眼双上转肌不全麻痹	眼上直肌麻痹##眼下斜肌麻痹
左眼眼球破裂左眼角膜破裂	眼球破裂伤##角膜裂伤
左足骨裂	"足骨折,未特指"
流产后延迟出血	流产后出血
预防乙肝	其他特指的预防措施
左肺斑片影右肺磨玻璃影性质待定	肺部阴影
横结肠乙状结肠管状腺瘤建议定期复查	乙状结肠良性肿瘤##横结肠良性肿瘤##管状腺瘤
陈旧性心肌梗死(冠脉支架植入术后)	陈旧性心肌梗死##冠状动脉支架植入术后状态
永存左上腔	永存左上腔静脉
原发不育月经不调多囊症	原发不孕##月经紊乱##多囊卵巢综合征[Stein-Leventhal综合征]
肾组织轻微改变伴球性硬化	肾小球硬化
先天性足外翻	足的其他先天性外翻变形
膀胱非浸润性乳头状尿路上皮癌	膀胱恶性肿瘤##非侵袭性乳头状尿路上皮癌
便秘关节炎，退变性	便秘##骨关节病
右肺腺癌 cT4N3M1c IV期免疫+靶向治疗	右肺恶性肿瘤##腺癌##恶性肿瘤免疫治疗##恶性肿瘤靶向治疗##淋巴结继发恶性肿瘤
纵膈腹主动脉旁腹膜后腹腔淋巴结化疗后	化学治疗
左手中指撕脱性骨折	指骨骨折
右前臂肌肉软组织缺血坏死	上肢供血不足
小细胞肺癌化疗	肺恶性肿瘤##小细胞癌##化学治疗
右斜疝嵌顿	单侧嵌顿性腹股沟斜疝
食管胃交界溃疡型低分化腺癌	食管胃连接部恶性肿瘤##腺癌
右膝OA右膝外踝三角zi综合征	单侧膝关节骨性关节病##踝关节撞击综合征
左腕小多角骨及钩骨撕脱性骨折	小多角骨骨折##钩骨骨折
冠心合并肺心病-心功能3级	肺源性心脏病##冠状动脉粥样硬化性心脏病##心功能III级(NYHA分级)
胰腺分裂症转归好转	胰腺分裂症
急性广泛前壁ST段抬高型心肌梗	急性广泛前壁心肌梗死##急性ST段抬高型心肌梗死
双肺肺大疱	肺大疱
右上肢肢体震颤原因待查特发性震颤可能性大	上肢震颤##特发性震颤
慢性覅而原先心脏病肺心功能失代偿期	未特指的心脏病
乳腺癌改良根治术后，化疗，上感\发烧	乳腺术后##乳腺恶性肿瘤##恶性肿瘤术后化疗##上呼吸道感染##发热##癌
右肺上叶恶性肿瘤治疗后的随诊检查	右肺上叶恶性肿瘤
右手经桡骨茎突月骨周围脱位正中神经卡压	腕舟骨月骨周围脱位##正中神经卡压综合征
化疗后小肠功能缺失	肠功能紊乱##化学治疗
泛发性皮炎	皮炎
右肺结节 肺癌不除外	肺占位性病变##肺恶性肿瘤##癌
C7髓内血管母细胞瘤术后	颈髓恶性肿瘤##血管母细胞瘤
肾变病综合征其他类型	肾病综合征
腹股沟淋巴结肿块	腹股沟淋巴结肿大
宫颈癌化疗	子宫颈恶性肿瘤##化学治疗##癌
盆腔继发癌	盆腔继发恶性肿瘤##转移性癌
鼻咽非角化癌	鼻咽恶性肿瘤##癌
大便异常其他的痔疮	痔##其他大便异常
"食管胃交界腺癌放化疗,血小板降低,白细胞降低,化疗,HER2(1+),PDL-1(强+约10%），EGFR(3+),MSS。"	食管胃连接部恶性肿瘤##腺癌##恶性肿瘤放疗##化学治疗##血小板减少##白细胞减少##化学治疗
右额叶放射性坏死	放射性脑病
右肱二头肌损伤	肱二头肌肌肉和肌腱损伤
左前降支中段中度肌桥	冠状动脉肌桥
大肠埃希杆菌感染	大肠杆菌感染
粘膜扁平苔藓伴糜烂	扁平苔癣
右手中指创伤性骨缺损伴甲床缺损	后天性指缺损
腹痛腹胀待查	腹痛##腹胀
右足第5跖骨基底部游离体建议结合病史	关节游离体
子宫内膜低分化伴神经内分泌分化腺癌	子宫内膜恶性肿瘤##伴有神经内分泌分化腺癌
急性发热性嗜中性皮肤病	急性发热性嗜中性皮病
肝动脉栓塞，射频治疗后	射频消融术后
巧克力囊肿切除守候治疗后	卵巢巧克力样囊肿##卵巢术后
肺组织内见多个纤维化病灶Masson小体	肺诊断性影像异常
射精快	早泄
右肺腺癌，骨转移，化疗，骨破坏	右肺恶性肿瘤##腺癌##骨继发恶性肿瘤##化学治疗##骨质破坏##转移性腺癌
十二指肠球部狭窄并不全梗阻	十二指肠狭窄##不完全性肠梗阻
皮肤软组织感染	软组织感染##皮肤感染
硬膜外血肿伴不全瘫胸3-5椎体水平	不完全性瘫痪##硬膜外血肿
右卵巢未成熟畸胎瘤III期	未成熟型畸胎瘤##卵巢恶性肿瘤
恶性疾病经静脉化疗	部位未特指的恶性肿瘤##化学治疗
双肺间质纤维化并感染	肺间质纤维化##肺部感染
隐性骶裂骶1隐裂	先天性腰骶椎隐裂
右腿撞伤	"下肢未特指的损伤,水平未特指"
慢性胆囊炎并结石	胆囊结石伴慢性胆囊炎
跟腱骨化	关节周围骨化
左膝半月板退变右踝关节退变	踝骨关节病
食管贲门低分化鳞癌并下颈部锁骨上淋巴结等转移	食管恶性肿瘤##贲门恶性肿瘤##颈部淋巴结继发恶性肿瘤##锁骨上淋巴结继发恶性肿瘤##鳞状细胞癌
动脉导管未闭(介入封堵术后)	动脉导管未闭##心脏介入封堵术后状态
糖尿病消化不良高尿酸高血脂	糖尿病##消化不良##高尿酸血症##高脂血症
冠状静脉窦无顶综合症	无顶冠状静脉窦综合征
混合性酸碱平衡紊乱	混合性酸碱平衡失调
臀先露前置血管帆状胎盘可能	前置胎盘##妊娠合并帆状胎盘
左足第2跖趾关节坏死左足平足症	扁平足
回盲部穿孔造瘘	人工造口状态##肠穿孔
1妊娠晚期胎盘伴灶片状钙化2胎膜大致正常	妊娠状态
双眼黄斑裂孔术后	黄斑裂孔##眼术后
免疫力低、前列腺肥大、皮炎	前列腺增生##皮炎
会阴体陈旧性裂伤	陈旧性会阴裂伤
脑血管病(头晕)	头晕##脑血管病
右侧肾盂粘膜炎性病变	肾盂炎
副乳腺囊性增生	副乳腺囊性增生
认知功能减退原因待查副肿瘤综合征	认知障碍##副肿瘤综合征
外伤性文身	纹身
夜间阵发性呼吸睡眠暂停	睡眠呼吸暂停低通气综合征
原发不孕男方无精子	无精子症##男性不育症
"胰腺占位，胰腺癌可能大,疼痛"	胰腺占位性病变##胰腺恶性肿瘤##癌##疼痛
弥漫大B细胞性非霍奇金淋巴瘤	弥漫大B细胞淋巴瘤
盆底、子宫直肠陷凹多发转移？	盆腔继发恶性肿瘤##转移性肿瘤##直肠子宫陷凹继发恶性肿瘤
右足瘢痕挛缩	瘢痕挛缩##足部瘢痕
先天性上腮裂漏	鳃裂瘘
宫颈考虑局灶腺体高级别异型增生	宫颈上皮不典型增生
腰背部囊肿	腰部囊肿##背部囊肿
糖尿病周围神经血管病变	糖尿病性周围神经病##糖尿病性周围血管病
创伤性蛛网膜下出血	创伤性蛛网膜下腔出血
双膝关节骨关节炎(双膝内翻畸形)	双侧膝关节骨性关节病##后天性膝内翻
结肠癌不除外	结肠恶性肿瘤##癌
左眼视网膜全部脱离右眼部分脱离	视网膜脱离
腰部、骶尾部外伤	下背损伤
记忆力减退原因待查短暂性脑缺血可能性大	脑血管供血不足
早孕子宫较大	妊娠状态
妊娠39+6周孕2产2枕左剖宫产	无指征剖宫产的单胎分娩
1.宫颈鳞癌Ⅱb期 T2bN0M0，2.双侧胸腔积液 双侧颈部淋巴结转移，3.肺内占位性病变性质待查，4.甲状腺结节，性质待定，5.心律失常 房早 短阵房速，6.恶病质，7.肺内感染，8.低钾血症，高钠血症	子宫颈恶性肿瘤##鳞状细胞癌##胸腔积液##颈部淋巴结继发恶性肿瘤##肺占位性病变##心律失常##房性期前收缩[房性早搏]##房性心动过速##恶病质##肺部感染##低钾血症##高钠血症
反复感染免疫功能紊乱	感染
右肘跌伤待查	上肢损伤##摔伤
双侧卵巢高级别浆液性乳头状癌	卵巢恶性肿瘤##浆液性表面乳头状癌
左踝关节重度创伤性OA	踝关节损伤##踝骨关节病
会厌软化气道轻度软化	气管软化症
直肠肿物性质待查	直肠肿物
雷诺病4右足背动脉闭塞	雷诺综合征##足部动脉闭塞
子宫内膜中低分化内膜样腺癌	子宫内膜样腺癌##子宫内膜恶性肿瘤
妊娠39+3周，胎儿宫内窘迫？	孕39周
新生儿法洛四联征	法洛四联症
粒细胞减少症 幼儿急疹	中性粒细胞减少症##幼儿急疹
II度II型窦房阻滞	窦房传导阻滞
右上臂腕部皮肤抓伤	上臂开放性损伤##腕部开放性损伤
颅内静脉窦血栓形成(治疗后)	非化脓性颅内静脉窦血栓形成
慢性浅表萎缩性胃炎伴咖啡斑	慢性萎缩性胃炎
结肠腺癌并癌性腹水	结肠恶性肿瘤##腺癌##恶性腹腔积液##癌
停经宫内囊样结构待查	子宫囊肿##停经
降结肠腺瘤	降结肠良性肿瘤##腺瘤
右肾重度萎缩功能严重不全	慢性肾功能不全##肾萎缩
迟发型急性移植物抗宿主反应I度	急性移植物抗宿主病
右膝关节外侧盘状半月板前交叉韧带止点血肿	先天性盘状半月板
颅底骨放射性坏死	放射性损害##骨坏死
泌尿结石，软组织伤	泌尿系结石
d发作性无力原因待查	肢体无力
咽炎扁桃体炎支气管炎	扁桃体炎##咽炎##支气管炎
高尿酸肝脏功能轻度减退高血糖	高尿酸血症##肝功能异常##血糖升高
左颈伤口愈合不良	开放性损伤愈合不良##颈部开放性损伤
鼻咽后壁鳞癌放化疗后	鼻咽后壁恶性肿瘤##鳞状细胞癌##恶性肿瘤放疗##化学治疗
双手皮肤破损及水泡	手部水泡##手部开放性损伤
四肢无力待诊可逆性血管收缩综合征	肢体无力
颅内多发大动脉狭窄	动脉狭窄
右小腿截肢肢麻气滞血瘀经络不畅	截肢
阴道腺癌	阴道恶性肿瘤##腺癌
意识障碍原因缺血缺氧性脑病心肺复苏后	缺氧缺血性脑病##意识障碍##心肺复苏术后
右乳腺纤维腺瘤切除	纤维腺瘤##乳腺良性肿瘤##乳腺术后
骶骨骨肉瘤	骶骨恶性肿瘤##骨肉瘤
颈肩腰痛	颈痛##肩痛##腰痛
右肝多发性HCC	肝细胞癌
食道符合Barrett食管胃体粘膜慢性	巴氏食管
纵膈积气积血	纵隔气肿##纵隔血肿
B2锥形牙牙间隙	锥形牙##牙齿间隙
急性重型内开放性颅脑损伤	开放性颅脑损伤重型
左侧额部皮肤挫伤	头皮挫伤
双侧胸腔积液伴肺膨胀不全	胸腔积液
肺部感染并呼吸衰竭	肺部感染##呼吸衰竭
停经355周院外B超提示胎儿胃泡增大	妊娠状态
喉咽癌化疗后	喉咽恶性肿瘤##癌##化学治疗
喷门癌肝转移	贲门恶性肿瘤##癌##肝继发恶性肿瘤##转移性癌
先天性视乳头缺失	先天性视神经乳头缺损
双眼白内障（未成熟期）	白内障
毛囊红斑黑变病	面颈部毛囊性红斑黑变病
银屑病玫糠伴化脓	银屑病##玫瑰糠疹
前列腺癌T3bN0M1	前列腺恶性肿瘤##癌
外伤;膝关节损伤关节病;失眠	膝关节损伤##关节病##失眠
腹膜后高分化脂肪肉瘤	腹膜后恶性肿瘤##高分化的脂肪肉瘤
双侧跟骨刺	跟骨骨质增生[跟骨骨刺]
右肺上叶侵润性腺癌	右肺上叶恶性肿瘤##腺癌
骶1椎板不连骶1隐裂	先天性腰骶椎隐裂
造瘘口旁组织脱出	人工造口状态
颈部木棍刺伤并存留	颈部开放性损伤
昏迷原因：颅脑疾患？	昏迷
乳房纤维腺瘤	乳腺良性肿瘤##纤维腺瘤
1.肝癌综合治疗后复发； 2.慢性乙肝	肝恶性肿瘤##恶性肿瘤复发##慢性乙型病毒性肝炎##癌
慢性酒精中毒酒精中毒性自主神经病	慢性酒精中毒性神经病##自主神经系统疾患
胸10腰骶部放疗后	放射治疗
颈部粥样硬化伴狭窄	颈动脉狭窄##颈动脉粥样硬化
股四头肌末端病臀上皮神经卡压征	臀上皮神经卡压综合征[臀上皮神经炎]##肌病
"右肺腺癌,纵隔淋巴结转移,左肾上腺转移"	右肺恶性肿瘤##腺癌##纵隔淋巴结继发恶性肿瘤##肾上腺继发恶性肿瘤##转移性腺癌
双侧颈动脉粥样硬化伴右侧斑块形成	颈动脉粥样硬化
眼浮肿面部红肿	水肿##面部肿胀
甲状腺滤泡性腺瘤伴囊性变	甲状腺良性肿瘤##滤泡性腺瘤
骶部皮肤擦伤	躯干浅表擦伤
左足趾肉芽肿性炎	趾感染##肉芽肿
右肺中叶鳞状细胞癌	右肺中叶恶性肿瘤##鳞状细胞癌
左上肺周围型低分化腺癌纵隔淋巴结转移 上呼吸道感染	左肺上叶恶性肿瘤##腺癌##纵隔淋巴结继发恶性肿瘤##转移性腺癌##上呼吸道感染
左肺陈旧性病灶斑片条索影	肺病##肺部阴影
直肠癌术后。低蛋白血症、前列腺增生	直肠术后##直肠恶性肿瘤##癌##低蛋白血症##前列腺增生
臀先露难产	臀先露引起的梗阻性分娩
F1胎儿宫内生长受限伴多发结构异常	胎儿生长受限
支气管炎(合并细菌感染）、	支气管炎##细菌感染
肝脏肿物切除术后	肝肿物##肝术后
双肾动脉狭窄，支架置入术后	肾动脉狭窄##血管支架植入术后状态
WHO肺高压心功能分级II级	心功能Ⅱ级(NYHA分级)##肺动脉高压
皮肤炎性周围神经病	多发性神经病[多发性神经炎/周围神经炎]
早孕阴道真菌	妊娠状态##真菌性阴道炎
右侧眶颧骨折	眶骨骨折##颧骨骨折
胆囊低分化腺癌	胆囊恶性肿瘤##腺癌
糖尿病高血压糖尿病神经病变	高血压##糖尿病##糖尿病伴神经系统并发症
葡萄酒色痣	鲜红斑痣[葡萄酒色痣]
原发不孕卵巢储备功能减低	原发不孕##卵巢功能减退
轻度抑郁伴躯体化功能障碍	伴有躯体症状的轻度抑郁发作
过敏性支气管肺曲菌病	变应性支气管肺曲霉病
双肺肺炎	肺炎
慢性移植物抗宿主反应病皮肤口腔肝脏	慢性移植物抗宿主病
IVF治疗准备宫腔预移植	试管婴儿
胸腺鳞状细胞癌术后	胸腺恶性肿瘤##鳞状细胞癌
左下肢血管狭窄伴足趾坏死	足坏死
左乳纤维瘤术后	乳腺术后##乳腺纤维瘤
停经25周B超提示胎儿之一隔离肺	孕25周##先天性肺隔离症
风心瓣膜病，AI（中-重）MS轻-中TIA过后，	风湿性心脏病##心脏瓣膜病##短暂性脑缺血发作##多发性硬化
右眼视网膜破裂并失明	视网膜破裂##单眼盲
骨关节病右膝关节置换术后	单侧膝关节骨性关节病##人工关节术后
右耳混合性聋传导性和感觉神经性聋	单侧混合性聋
右额顶动静脉畸形	脑血管畸形
浮肿血瘀胸痹咳嗽咽痛	咳嗽##咽痛##水肿
右乳浸润性T2N3M0Her-2阳性型	乳腺恶性肿瘤
右足第2趾甲床部分缺损右足第3趾甲床撕脱	足趾损伤
慢性移植物抗宿主反应病皮肤口腔	慢性移植物抗宿主病
胃十二指肠溃疡伴有穿孔	十二指肠溃疡伴穿孔##胃溃疡伴穿孔
化疗相关口腔黏膜及胃肠道损害	化疗药物反应
右肺腺癌术后化疗放疗后，脑M，CT显示复发。	右肺恶性肿瘤##腺癌##脑继发恶性肿瘤##恶性肿瘤术后放疗##恶性肿瘤术后化疗##恶性肿瘤复发
"骨质疏松伴病理性骨折,过敏性鼻炎伴哮喘"	骨质疏松伴病理性骨折##过敏性鼻炎[变应性鼻炎]##支气管哮喘
食管下段癌化疗后	食管下三分之一的恶性肿瘤##化学治疗##癌
淋巴瘤的化疗治疗滤泡	滤泡淋巴瘤##化学治疗
继发性间质肺疾病	间质性肺病##放射性损害
粒细胞减低症	中性粒细胞减少症
深静脉血栓形成后综合征（左下肢）	下肢深静脉血栓形成
胸椎腰椎病变并不全瘫	不完全性瘫痪##腰椎病
颅脑外伤性意识障碍颞叶硬膜下积液	硬脑膜下积液##意识障碍
右下叶肺癌	右肺下叶恶性肿瘤##癌
乙状结肠中分化腺癌切除术	乙状结肠恶性肿瘤##腺癌##结肠术后
缺血性脑改变脑内多发缺血性改变	脑血管供血不足
右半结肠中分化管状腺癌	结肠恶性肿瘤##管状腺癌
双眼玻璃体出血	玻璃体积血
妊娠期甲状腺机能减退症	妊娠合并甲状腺功能减退
胃早期癌	胃恶性肿瘤##癌
子宫颈鳞癌	子宫颈恶性肿瘤##鳞状细胞癌
更年期掌跖角皮病	角化病
胎儿异常永存左上腔泌尿系统异常	永存左上腔静脉
急性脊髓外伤	脊髓损伤
药物性损害	药物不良反应
老年痴呆(重度)	阿尔茨海默病
双颈动脉，双股动脉，胫后动脉粥样硬化	颈动脉硬化##股动脉粥样硬化##胫动脉粥样硬化
"股癣,毛周角化症"	股癣##毛发苔藓
糖尿病性心脏植物神经病变	糖尿病##心脏神经症
脐动脉舒张期血流信号缺失一胎儿	脐血流异常
子宫颈中低分化鳞状细胞癌	子宫颈恶性肿瘤##鳞状细胞癌
T-幼淋细胞白血病	T细胞型幼淋巴细胞白血病
"左眼睑结膜恶性黑色素瘤术后,反复复发术后,"	结膜恶性肿瘤##眼睑恶性黑色素瘤##恶性黑色素瘤##眼术后##恶性肿瘤复发
母体丙肝之新生儿	丙型病毒性肝炎
酒精性肝损坏	酒精性肝病
外阴癌	外阴恶性肿瘤##癌
带状疱疹性耳炎	带状疱疹伴有其他并发症
停经305周B超提示胎儿脑沟回减少	妊娠状态
左下肢扁平苔藓样疹伴皮肤干燥	扁平苔癣
面部原位黑(色素)瘤	面恶性黑色素瘤##原位黑色素瘤
直肠肛管内盲瘘	盲管瘘
1.扁桃体炎2.头晕，呕吐待查	扁桃体炎##头晕##呕吐
轻度脑动脉硬化性	脑血管硬化
胸紧高TCTG	高甘油三酯血症##高胆固醇血症
腰背部擦伤	躯干浅表擦伤
左侧冠脉扩张心功能0级	冠状动脉扩张##心功能不全
右侧盆腔异位肾伴旋转不良	肾异位##先天性肾旋转不良
Q-T间期延长综合征	Q-T间期延长
卵巢癌肿瘤细胞减灭术术后	卵巢恶性肿瘤##癌##卵巢术后
乙状结肠溃疡型中-低分化腺癌	乙状结肠恶性肿瘤##腺癌
左侧肋骨骨挫伤	肋骨骨折
心脏起搏器更换电池	心脏起搏器调整和管理
右侧眼睑皮下静脉畸形	周围静脉畸形
右乳占位（MT可能）	乳腺恶性肿瘤##乳房占位
盆腔炎急性发作	盆腔炎
(肺刀刺伤)	肺的其他损伤##刀刺伤
膝关节外翻	膝外翻
左额叶脑肿胀	脑水肿
睾丸后天性缺失	后天性睾丸缺失
食管溃疡型中分化鳞状细胞	食管恶性肿瘤##鳞状细胞癌
多脏器功能不全神志肾脏肝脏心肌血液凝血	多脏器功能障碍综合征[MODS]
双眼黄斑病变	视网膜病
右颞顶枕及基底节区多发梗塞	脑梗死##多发性脑梗死##基底节脑梗死
高血压病病	高血压
左膝内侧滑膜皱裂嵌顿	膝关节滑膜皱襞综合征
绒毛状-管状腺瘤	管状绒毛状腺瘤
咽痒咳嗽1周	咳嗽
"食管癌 造影检查,纵隔腹腔淋巴结转移,胃镜检查、局麻、预防出血,疼痛,成人不能进食、鼻饲"	食管恶性肿瘤##纵隔淋巴结继发恶性肿瘤##腹腔淋巴结继发恶性肿瘤##疼痛##进食障碍##癌
耳特指疾患双耳听力障碍	听功能障碍##耳其他特指的疾患
复发性右侧硬膜下积血及大脑镰旁右侧积血	硬膜下血肿
原发性中枢神经系统淋巴瘤放化疗后	淋巴瘤##恶性肿瘤放疗##化学治疗
慢性中耳炎胆脂瘤形成	中耳胆脂瘤##中耳炎
慢性肺源性心脏心功能失代偿期	慢性肺源性心脏病##心功能不全
右前臂掌背侧肌肉缺血坏死	上肢供血不足
右侧颞顶骨折	顶骨骨折##颞骨骨折
两侧脑室旁脱髓鞘缺血	脱髓鞘性脑病##脑血管供血不足
右锁骨骨折伴肩锁关节脱位	锁骨骨折##肩锁关节脱位
节育器异位继发肠壁部分穿孔	避孕环移位##肠穿孔
直肠癌术后 骨髓转移？	直肠术后##直肠恶性肿瘤##癌##骨髓继发恶性肿瘤##转移性癌
球菌性龈口炎	口炎##细菌感染
右上肺鳞癌术后（pT2N2MO	肺术后##右肺上叶恶性肿瘤##鳞状细胞癌
右足舟楔关节坏死组织慢性肉芽肿性肿	肉芽肿
腰椎管狭窄症术后	腰椎管狭窄##腰椎术后
强直性脊柱炎并胸腰椎后凸畸形	强直性脊柱炎##胸椎后凸##腰椎后凸
四肢火焰烧伤	上肢烧伤##下肢烧伤
宫颈中分化鳞癌IIb期术后放化疗后	子宫颈恶性肿瘤##鳞状细胞癌##恶性肿瘤术后化疗##恶性肿瘤术后放疗
宫颈囊肿、卵巢囊肿	卵巢囊肿
左下肢跛行原因肌力V级	肌无力
子宫发育不全	子宫发育不全
胃窦毛细血管扩张	胃肠道毛细血管扩张症
阴道前壁中度膨出后壁轻度膨出	阴道前后壁脱垂
2宫腔内容物增生期样子宫内膜伴息肉样增生	子宫内膜息肉
升结肠符合管状腺瘤乙状结肠管状腺瘤	乙状结肠良性肿瘤##升结肠良性肿瘤##管状腺瘤
双足CMT	腓骨肌萎缩
胸9锥体放疗后	放射治疗
新生儿脑损害	新生儿脑病
卵巢成熟性囊性畸胎瘤伴神经胶质成分	卵巢良性肿瘤##成熟型囊性畸胎瘤
双侧放射冠侧脑室前后角白质多发缺血梗塞灶	多发性脑梗死
硬膜下积血左侧顶部双侧枕部蛛网膜下腔积血	蛛网膜下腔血肿##硬膜下血肿
左腋窝淋巴结增生性病变	腋下淋巴结肿大
隔离肺	先天性肺隔离症
多趾（左足）	多趾
胸髓压迫症伴截瘫	脊髓压迫症##未特指的截瘫
多处皮肤擦挫伤、多处软组织伤	多处皮肤浅表擦伤##多处皮肤浅表挫伤##多处损伤
头面部清创缝合术后	清创术后
乙状结肠癌同时性肝转移IV期，化疗白细胞低 肝损害，消化不良，腹泻	乙状结肠恶性肿瘤##肝继发恶性肿瘤##化疗药物反应##白细胞减少##肝损害##消化不良##O##癌##转移性癌
腰骶筋膜炎	筋膜炎
多发颌面骨骨折	面骨多发性骨折
高血压病并左房增大	高血压
肱骨内上髁炎左侧	内侧上髁炎
(腿肿痛)	下肢肿胀##下肢疼痛
T12椎体压缩性改变	胸椎压缩性骨折
特指耳硬化鼓膜硬化	其他耳硬化
右上肢皮下多发硬结灶性质待定	皮肤硬结
乳腺恶性肿瘤治疗后的随诊检查	乳腺恶性肿瘤##恶性肿瘤其他治疗后的随诊检查
药疹大疱性表皮坏死松解症	莱尔综合征[lyell综合征]
其他粘液囊囊肿M713臀	其他的粘液囊囊肿
慢阻肺肺心病急性发作	肺源性心脏病##慢性阻塞性肺疾病
乳腺癌化疗低血象	乳腺恶性肿瘤##癌##化学治疗
风心病主动脉瓣狭窄	风湿性主动脉瓣狭窄
上感（胃肠型）腹腔残余感染	胃肠型感冒##上呼吸道感染##腹腔感染
冠状动脉微小血管综合症	X综合征
肝胃间淋巴结放疗后	放射治疗
膝关节骨关节炎双膝屈曲挛缩内翻畸形	双侧膝关节骨性关节病##关节挛缩##膝内翻
"左侧乳腺癌术后,双肺转移"	乳腺术后##乳腺恶性肿瘤##癌##肺继发恶性肿瘤##转移性癌
右手皮脂腺囊肿	皮脂腺囊肿
胆囊特指疾病胆囊隆起样改变性质待定	胆道其他特指的疾病
双眼ROPⅡ区1期Plus-	早产儿视网膜病
真红细胞增加肾功能减退	真性红细胞增多症##肾功能异常
左耳听阈异常左侧乳突积液	其他听觉异常
慢性风湿性瓣膜疾病	风湿病
头昏手麻语言吃力反应慢	头晕##言语困难
脑蛛网膜下腔出血	蛛网膜下腔出血
肝硬化脾亢(术后)	肝硬化##脾功能亢进##O
胸部腹部软组织肿瘤	腹部肿瘤##胸部肿瘤
右侧结核性炎	结核感染
宫内感染败血症	败血症
鼻咽癌放疗后未控	鼻咽恶性肿瘤##癌##恶性肿瘤放疗##化学治疗
右肺腺癌并多发脑转移放疗后，多发骨转移	右肺恶性肿瘤##腺癌##脑继发恶性肿瘤##恶性肿瘤放疗##骨继发恶性肿瘤##转移性腺癌
肺源心脏病心功能2级	肺源性心脏病##心功能Ⅱ级(NYHA分级)
慢性移植物抗宿主反应病皮肤肝脏骨骼关节	慢性移植物抗宿主病
右侧小脑半球大面积脑梗塞	小脑梗死##大面积脑梗死
右侧颈内动脉烟雾综合征不除外	烟雾病[脑底异常血管网病]
慢性荨麻疹（皮肤划痕征）	慢性荨麻疹##人为性荨麻疹
右足底皮肤挫裂伴肌肉坏死	足部挫伤##足坏死
霍多金淋巴病	霍奇金淋巴瘤
腰椎同描述考虑为慢性化脓性炎请结合临床	炎性脊椎病
霉菌性咽喉炎	咽炎##喉炎
右大腿高分化骨肉瘤	骨肉瘤##股骨恶性肿瘤
唇部白斑颊扁平苔藓	口腔粘膜白斑病##口腔扁平苔癣
子宫颈小细胞癌	子宫颈恶性肿瘤##小细胞癌
盲肠腺瘤	盲肠良性肿瘤##腺瘤
冠心脏心肌缺血	冠状动脉粥样硬化性心脏病##心肌供血不足
胆囊管结石伴胆囊炎	胆囊管结石##胆囊炎
全身腋窝腹腔颈部下肢淋巴管囊肿	囊性淋巴管瘤
右小趾甲畸形	未特指的甲疾患
慢性肾功能衰竭并急性肾衰	慢性肾衰竭##急性肾衰竭
横结肠低分化腺癌	横结肠恶性肿瘤##腺癌
上消化道出血胃溃疡可能性大	上消化道出血##胃溃疡
胎儿双足内翻	先天性内翻足
上呼吸道感染哭闹待查	上呼吸道感染
直肠下端占位？炎症？	直肠占位性病变##直肠炎
反应性T淋巴细胞增生	淋巴细胞增殖性疾病
子宫阴道前壁膨出Ⅳ期阴道后壁膨出Ⅲ期	阴道前后壁脱垂##子宫阴道脱垂
原发不孕双侧输卵管通畅	原发不孕##输卵管术后
右侧上额窦炎	鼻窦炎
肠系膜血管缺血性病变及痉挛性改变	肠系膜动脉供血不足##肠痉挛
右侧足背软组织劳损	足的其他和未特指部位的扭伤和劳损
PTCA＋冠状动脉内支架植入术	冠状动脉支架植入术后状态
分泌期样子宫内膜伴息肉	子宫息肉
右手无力发胀待查神经卡压	肌无力
停经32周B超提示延髓池增宽	妊娠状态
"直肠癌肝转移术后,肺转移."	直肠恶性肿瘤##肝继发恶性肿瘤##肺继发恶性肿瘤##癌##转移性癌
左眼黄斑病变渗出	视网膜病
意识不清待诊	意识障碍
右额颞叶脑梗死合并脑出血破入脑室	脑梗死##脑出血
急性B淋巴细胞型白血病(PH+)	B细胞急性淋巴细胞白血病
右肾萎缩并多发小囊肿	肾萎缩##肾囊肿
宫内环移位	避孕环移位
左小腿开放性伤口愈合不良	小腿开放性损伤##开放性损伤愈合不良
门诊以胃窦管状腺瘤收入院	胃良性肿瘤##管状腺瘤
胃溃疡型低分化腺癌	胃恶性肿瘤##腺癌
股骨、胫骨骨折内固定术后	股骨骨折##胫骨骨折##骨折术后
发作性意识不清原因待查心源性	意识障碍
停经23周发现胎儿胃泡旁点状强回声	孕23周
33周5天早产儿	"早产儿(孕期等于或大于32整周,但小于37整周)"
甲状腺非霍奇金淋巴瘤	甲状腺淋巴瘤##非霍奇金淋巴瘤
贲门胃底病变伴狭窄	贲门口狭窄##胃和十二指肠未特指的疾病
肺部感染支气管扩张咯血	肺部感染##支气管扩张症##咯血
男性生殖器官特指疾病	男性生殖器官其他特指的疾患
右上肺周围型低分化腺癌Ⅳ期	右肺上叶恶性肿瘤##腺癌
右前臂软组织劳损	累及上肢多个部位的脱位、扭伤和劳损
大血管异位	大动脉转位
髓性脂肪瘤	骨髓脂肪瘤
腕关节骨性关节炎(单侧严重性)	腕骨关节病
白细胞疾患白细胞低	白细胞减少##未特指的白细胞疾患
左手抖动原因待查帕金森氏病	帕金森病##不自主运动
右半结肠隆起型中分化癌侵及粘膜下层	结肠恶性肿瘤##癌
甲状腺机能亢进-甲状腺机能减退综合征	甲状腺功能亢进症##甲状腺功能减退
脑垂体肿瘤放疗后	垂体恶性肿瘤##恶性肿瘤放疗
第1次化疗后	化学治疗
2左胫骨远端骨不连	胫骨骨折不连接
毛支炎（恢复期），哮喘？	细支气管炎##恢复期##支气管哮喘
右眼视网膜裂空变性激光后	视网膜裂孔
宫颈上皮内病变Ⅲ级累及腺体	子宫颈上皮内瘤变III级[CINIII级]
热水烫伤面颈部双上肢躯干7%TBSAⅡ	沸水烫伤##上肢烫伤
结多发肠绒毛管状腺瘤	结肠良性肿瘤##乳头状管状腺瘤
右侧股骨内侧副韧带止点撕脱性骨折	股骨骨折
右小腿皮肤坏死缺损	下肢皮肤坏死##下肢皮肤缺损
胃淋巴肉瘤	胃淋巴瘤
盆腔神经鞘瘤	盆腔良性肿瘤##神经鞘瘤
B超提示胎儿单脐动脉双侧肾窦轻度分离	胎儿单脐动脉
Q64800泌尿系统的特指先天性畸形	泌尿系统未特指的先天性畸形
右足犬抓伤	足部开放性损伤##被狗抓伤
食道胃底静脉中度曲张	胃底静脉曲张##食管静脉曲张
慢性重度萎缩伴肠化hp	肠上皮化生##幽门螺旋杆菌感染
左甲MT术后	甲状腺恶性肿瘤##甲状腺术后
右乳腺浸润性导管癌T1N0M0Ⅰ期	乳腺恶性肿瘤##浸润性导管癌
退行性心瓣膜病	老年性心脏瓣膜病
神经症植物神经共紊乱	植物神经功能紊乱##神经症性障碍
肠道DLBCL化疗后复查	弥漫大B细胞淋巴瘤##肠道恶性肿瘤##化学治疗
糖尿病性肾病(肾小球硬化症)	糖尿病性肾病##肾小球硬化
低钠低钾低氯	低钠血症##低钾血症##低氯血症
坐骨神经炎	下肢单神经炎
甲状腺低功4肾功不良	甲状腺功能减退##肾功能异常
肥大细胞增生症	肥大细胞增生症
结肠癌复发	结肠恶性肿瘤##癌##恶性肿瘤复发
直肠癌术后回肠造口还纳术	直肠术后##直肠恶性肿瘤##癌
食道异物穿孔伴感染	食管内异物##食管穿孔##感染
灶性复鳞上皮呈CINIII级并累及腺体	子宫颈上皮内瘤变III级[CINIII级]
颈椎过伸伤伴不全瘫	不完全性瘫痪##脊柱损伤
外耳道股瘤	骨软骨瘤##耳部肿瘤
左膝内侧间室OA内侧半月板脱位	单侧膝关节骨性关节病
左颈总动脉发育异常	颈内动脉畸形
颈胸椎放疗中	放射治疗
滋养叶细胞瘤	滋养细胞病
"左上肺占位,肺癌"	肺占位性病变##左肺上叶恶性肿瘤##癌
强直性脊柱炎伴胸腰椎后凸畸形	强直性脊柱炎##胸椎后凸##腰椎后凸
三踝骨折术后	三踝骨折##骨折术后
白内障晶状体置换术后（右）	白内障##眼术后
骶尾部符合脊髓栓系-脂肪瘤型	脊髓脂肪瘤
纵隔鳞癌	纵隔恶性肿瘤##鳞状细胞癌
耳后腮裂漏管	鳃裂瘘
面部色素沉着待查	色素沉着未特指的疾患
左膝刺伤	"下肢未特指的损伤,水平未特指"
急性迟缓性麻痹左下肢	弛缓性瘫痪[周围性瘫痪]
腹泻病，支气管肺炎（恢复期）	支气管肺炎[小叶性肺炎]##肺炎恢复期##O
癫痫周围神经病	癫痫##多发性神经病[多发性神经炎/周围神经炎]
"房间隔缺损(Ⅱ型,小）"	房间隔缺损
胰腺神经内分泌肿瘤G2术后多发转移	胰腺术后##神经内分泌肿瘤G2##广泛转移性肿瘤
左前胸壁包块:囊肿	胸部囊肿
左膝部刺伤	"下肢未特指的损伤,水平未特指"
完全右束支阻滞心功能I级	完全性右束支传导阻滞##心功能I级(NYHA分级)
颈3-6椎间盘突出	颈椎间盘突出
盆腔未分化肉瘤术后	盆腔恶性肿瘤##未分化肉瘤##盆腔术后
右肺腺Ca	右肺恶性肿瘤##腺癌
腮腺多形性腺瘤切除术后	腮腺良性肿瘤##多形性腺瘤
色素失调症	色素失禁症
发作性意识不清原因待查君爵	意识障碍
特指胎盘疾病胎盘残留	胎盘部分残留不伴出血##其他的胎盘疾患
脊椎转移癌	脊柱继发恶性肿瘤##转移性癌
喉癌治疗后的随诊检查	喉恶性肿瘤##癌##恶性肿瘤治疗后的随诊检查
肌腱血管损伤	身体未特指部位的血管损伤
双卵巢白体右输卵管慢性炎伴管腔扩	输卵管卵巢炎##输卵管狭窄
纵隔淋巴结放化疗后	恶性肿瘤放疗##化学治疗##未特指的淋巴结恶性肿瘤
宫颈上皮内瘤样变III级累腺	子宫颈上皮内瘤变III级[CINIII级]
感音神经性耳聋	感音神经性聋
甲状腺功能减低Turner综合症	甲状腺功能减退##特纳综合征[Turner综合征]
多发胸椎骨质破坏性质	骨质破坏
双下肢浮肿待查低白蛋白血症可能性大	低蛋白血症##下肢水肿
阴茎根部刀伤	"阴茎开放性损伤##接触刀、剑或匕首造成的损伤,在未特指场所"
妊娠滋养细胞肿瘤第一次化疗后	化学治疗##滋养细胞病
下肢周围神经病变	多发性神经病[多发性神经炎/周围神经炎]
格林巴利综合征可能性大脑白质病变不除外	吉兰-巴雷综合征##脑白质病
蹼状阴茎	蹼状阴茎[阴茎阴囊融合]
"肺肿瘤,恶性(术后)"	肺恶性肿瘤##肺术后
左拇趾及左足背缺血坏死	下肢皮肤坏死
左第6-8肋腋部及第11肋骨折	四根以上肋骨骨折不伴第一肋骨骨折
胃底低分化腺癌	胃底恶性肿瘤##腺癌
"胃窦癌腹腔广泛淋巴结转移,缺铁性贫血 巨细胞贫血 维生素缺乏,胃食管反流 消化道出血不除外,恶心、呕吐,长期不能进食"	胃窦恶性肿瘤##癌##腹腔淋巴结继发恶性肿瘤##缺铁性贫血##O##维生素缺乏##胃食管反流##O##恶心##呕吐##进食障碍
母体妊娠糖尿病之新生儿	糖尿病母亲婴儿
Bowen环状扁平苔藓	扁平苔癣##鲍恩病
左拇外伤术后	手部损伤
白血病的化疗治疗AML-M2	白血病##化学治疗
左侧结节性甲状腺肿物	甲状腺肿物
结肠腺瘤	结肠良性肿瘤##腺瘤
右手拇指关节皮缺损	皮肤缺损
中度缺锌铅明显增高抵抗差多汗	锌缺乏##铅中毒
痣，甲白点	痣##白甲
咽部乳头状瘤	咽良性肿瘤##乳头状瘤
子宫纵膈附件囊肿	输卵管卵巢囊肿##子宫纵隔
右股骨外侧骨挫伤	股骨骨折
取出左胫骨内固定装置	取出内固定装置
过敏性鼻炎并哮喘	过敏性鼻炎[变应性鼻炎]##支气管哮喘
颅骨骨折术后	颅骨骨折##骨折术后
患者肿瘤晚期恶液质变予静脉营养支持	恶病质##恶性肿瘤
双肾动脉支架置入术PTA	血管支架植入术后状态
前降支肌桥重度	冠状动脉肌桥
右肾造瘘后	肾造口状态
"糖尿病,糖尿病伴肾并发症,高血压病,脑梗死,慢性肾衰竭,冠状动脉粥样硬化性心脏病,2型糖尿病伴多并发症"	糖尿病##未特指的糖尿病伴有肾的并发症##高血压##脑梗死##慢性肾衰竭##冠状动脉粥样硬化性心脏病##非胰岛素依赖型糖尿病伴有多个并发症
深脉血栓形成下腔静脉上段双肾静脉	静脉血栓形成
双侧额叶脑出血术后	额叶出血##脑术后
肺间质病变合并肺部感染	间质性肺病##肺部感染
感染后头痛	头痛##感染
脑静脉窦发育不全	先天性动静脉畸形
乳麻尿	乳糜尿
乙状结肠单腔造瘘术后	结肠造口状态
左乳内上象限浸润性导管癌II级术后化疗后	乳腺恶性肿瘤##浸润性导管癌##恶性肿瘤术后化疗
阿尔珀斯病灰质变性Alpers	弥漫性进行性脑灰质变性[阿尔珀斯]
右乳外上多发实性占位	胸部占位
咽异物感、甲状腺左叶结节	咽异感症
右肾囊肿伴结石	肾结石##肾囊肿
右卵巢癌	卵巢恶性肿瘤##癌
多脏器功能障碍肝肾脑凝血	多脏器功能障碍综合征[MODS]
盆腔复发放疗后	盆腔恶性肿瘤##恶性肿瘤复发##恶性肿瘤放疗
小细胞低色素多发性抽动	不自主运动##低色素性小细胞性贫血
新生儿肾脏异常胎儿融合肾	融合肾
左肱骨骨质缺损	骨质破坏
孕13周孕妇心脏左房大	孕13周##心房扩大
脑损伤低钙	低钙血症##中枢神经系统未特指的疾患
双下肢动脉硬化	肢体动脉硬化
穿刺活检，右肺占位，预防出血	肺占位性病变
右眼假性剥脱综合症	假性囊膜剥脱综合征
精神异常原因待查	精神障碍
先天性面部不对称待查	先天性发育异常
右肺小细胞肺癌放化疗后	右肺恶性肿瘤##小细胞癌##化学治疗##恶性肿瘤放疗
右甲状旁腺腺瘤	甲状旁腺良性肿瘤##腺瘤
面部皮肤擦伤	面部擦伤
胫骨下段先天性骨不连	先天性胫骨假关节
单个手指离断	其他单个手指创伤性切断(完全)(部分)
脾肿大脾内囊样灶	脾大##脾囊肿
T183肾移植后临界性排异反应	肾移植排斥
右肺错构瘤可能性大	肺错构瘤
弥漫性脑病脑器质性功能障碍	弥散性脑病##脑病[器质性脑病]
骶尾部外伤骨折	尾骨骨折##骶骨骨折
肋轻度外翻低锌低铁	锌缺乏##铁缺乏##肋骨畸形
空肠旋转不良并空肠异位胰腺	先天性肠旋转不良##空肠异位胰腺
咳喘原因待查	咳嗽##喘息
左下肢大面积软组织撕脱缺损	下肢撕脱伤
白内障(右眼术后)	白内障##眼术后
肝内外胆管结石并急性胆管炎	胆管结石##急性胆管炎
左乳纤维腺瘤	纤维腺瘤##乳腺良性肿瘤
颈椎多发骨质破坏性质待排	骨质破坏
左踝创伤性下垂足	踝关节损伤##足畸形
窦性不齐左室高电压轻度缺血改变	窦性心律失常
面部皮炎	皮炎
左足踇趾外翻锤状趾	足拇外翻##锤状趾
外阴癌放疗	外阴恶性肿瘤##癌##恶性肿瘤放疗
环枕融合环枢脱位	先天性环枕融合##寰枢椎脱位
手臂划伤要求注射TAT	上肢开放性损伤
左上肺占位:癌	肺占位性病变##左肺上叶恶性肿瘤##癌
糖尿病糖尿病肾病糖尿病性视网膜病变	糖尿病##糖尿病性肾病##糖尿病性视网膜病变
腹腔动脉多发斑块伴管腔狭窄	动脉狭窄
脊髓圆锥受压并双下肢不全瘫	不完全性瘫痪##脊髓受压
退变髓核组织伴钙盐沉积	钙质沉着症
慢性非萎缩性伴胃窦部多发糜烂	慢性浅表性胃炎##糜烂性胃炎
右手掌切割伤	手部开放性损伤
脸部色素沉着	色素沉着未特指的疾患
右侧颞部疖肿粒细胞减少	头部疖##中性粒细胞减少症
右膝髌股关节退变股骨内髁骨梗死	单侧膝关节骨性关节病##骨坏死
慢性阻塞行肺心病	慢性肺源性心脏病
右肱骨大转子撕脱性骨折	肱骨骨折
3、多发肋骨骨折伴双肺挫伤、血胸	肋骨骨折##肺挫伤##血胸
双侧甲状腺乳头状微小癌	甲状腺恶性肿瘤##乳头状微小癌
结节性甲状腺肿伴囊性变	结节性甲状腺肿##囊性甲状腺肿
冠心病;上呼吸道感染;外伤	冠状动脉粥样硬化性心脏病##上呼吸道感染
肾组织增殖性病变半球性硬化815不排除糖	肾小球硬化
贲门口病变-恶性病变可能性大	贲门恶性肿瘤
乙状结肠管状腺癌维持性化学治疗	乙状结肠恶性肿瘤##管状腺癌##恶性肿瘤维持性化学治疗
右侧附件区良性囊性病变右侧输卵管积液可能	输卵管卵巢囊肿##右侧输卵管积水
胚胎移植后宫外孕	胚胎移植术后##异位妊娠
T6T12椎体陈旧性压缩改变	胸椎压缩性骨折##陈旧性胸椎骨折
左足伤口不愈合	足部开放性损伤##开放性损伤愈合不良
右侧股四头肌送检横纹肌组织部分萎缩变性	肌纤维变性##下肢肌肉萎缩
右肺上叶少许纤维硬结陈旧性病变可能	肺诊断性影像异常
口腔破裂	口腔和咽喉部损伤
结肠癌，上感，肠炎	结肠恶性肿瘤##癌##上呼吸道感染##肠炎
并肝肾综合症	肝肾综合征
"右肺大细胞癌,骨转移,纵隔淋巴结转移,锁骨上淋巴结转移,刺激性咳嗽"	右肺恶性肿瘤##大细胞癌##骨继发恶性肿瘤##转移性大细胞癌##纵隔淋巴结继发恶性肿瘤##锁骨上淋巴结继发恶性肿瘤##咳嗽
右跟腱断裂伴撕脱骨折	跟腱断裂##跟骨骨折
"前列腺癌根治性切除术后,前列腺癌生化复发 局部放疗"	前列腺术后##前列腺恶性肿瘤##前列腺恶性肿瘤##恶性肿瘤复发##恶性肿瘤放疗##癌
右膝部完全盘状半月板髌骨内侧皱襞	先天性盘状半月板
皮肤棘层松解性疾患NOS	其他特指的皮肤棘层松解性疾患
结膜特指疾患	结膜其他特指的疾患
右甲MT术后	甲状腺恶性肿瘤##甲状腺术后
右肱骨放疗中	放射治疗
右肩袖巨大缺损右肱骨头部分坏死取药	肱骨头缺血性坏死##肩袖肌腱损伤
褥疮性溃疡	压疮
肝继发性恶性肿瘤介入治疗	肝继发恶性肿瘤##恶性肿瘤介入治疗
原发性肝癌伴门静脉癌栓	肝恶性肿瘤##门静脉瘤栓##癌
左足成年人柔韧性平足症	扁平足
右侧乳腺外上象限恶性肿瘤	乳腺外上象限恶性肿瘤
先天性房间隔缺损	房间隔缺损
右肺小细胞癌化疗	右肺恶性肿瘤##小细胞癌##化学治疗
食管胸中下段鳞癌 家属咨询	食管胸中段恶性肿瘤##食管胸下段恶性肿瘤##鳞状细胞癌
急性喉气管支气管炎，酸性细胞高	急性气管支气管炎##急性喉炎##O
左室增大左室心肌致密化不全	先天性心肌致密化不全
多脏器功能不全累及呼吸心肌肝肾凝血代谢等	多脏器功能障碍综合征[MODS]
鞍区坏死组织不除外寄生虫虫卵	寄生虫病
心室性期前收缩	室性期前收缩
副乳腺癌	副乳腺恶性肿瘤##癌
颅内多发性病灶囊虫病	囊虫感染
下肢上皮样肉芽肿性病变伴凝固性坏死右大腿	肉芽肿
卵巢无性细胞瘤	卵巢恶性肿瘤##无性细胞瘤
腹痛待查(左下)	下腹痛
右臀部纤维肉瘤	臀部恶性肿瘤##纤维肉瘤
新生儿缺氧缺血性脑损伤	新生儿缺氧缺血性脑病
青霉素”药物过敏史	青霉素过敏史
老年性白内障(术前)	老年性白内障##眼术后
糖尿病\胸闷\胸痛	糖尿病##胸闷##胸痛
心律不齐房颤	心律失常##心房颤动[心房纤颤]
踝关节骨折脱位	踝关节骨折##踝关节脱位
脑白质缺血脱髓鞘改变	脱髓鞘性白质脑病##脑血管供血不足
腰椎间盘突出伴椎管狭窄症	腰椎间盘突出##腰椎管狭窄
左眼睑缺损闭合不全	眼睑闭合不全[兔眼]
喉化学灼伤	口腔及咽喉部化学伤
膝关节滑膜皱襞	膝关节滑膜皱襞综合征
支气管肺炎、轮状病毒肠炎、心肌损害？	支气管肺炎[小叶性肺炎]##轮状病毒性肠炎##心肌损害
腰5右侧椎板缺失骶1隐裂	先天性腰骶椎隐裂
盆腔脉管瘤栓	肿瘤栓子
"心律失常胆汁反流性胃炎,乳腺增生,咳嗽待查（肺小结节）,腹部不适,胃镜检查，肠镜检查"	心律失常##反流性胃炎##乳腺增生##咳嗽##肺占位性病变##胆汁反流
小脑蚓部髓母细胞瘤术后	髓母细胞瘤##脑术后
右下肢浮肿待查淋巴回流障碍可能	淋巴回流障碍##下肢水肿
小脑萎缩性共济失调	小脑萎缩##共济失调
外科切口瘢痕相关行房扑消融术后	心脏射频消融术后##手术后瘢痕
直肠癌伴不全肠梗阻	直肠恶性肿瘤##不完全性肠梗阻##癌
右侧乳腺癌pT2N2M0	乳腺恶性肿瘤##癌
胆总管结石(术后)	胆总管结石##胆道术后
老年斑	脂溢性角化症
非霍奇金套细胞淋巴瘤III期B	非霍奇金淋巴瘤##套细胞淋巴瘤
膀胱平滑肌瘤	膀胱良性肿瘤##平滑肌瘤
右上中肺腺癌 cT3N3M1b Ⅳ期EGFR基因检测野生型	右肺恶性肿瘤##腺癌
多动症？	注意缺陷与多动障碍
退行性脑病	未特指的脑病
肺炎喉炎Ⅱ°喉梗阻	肺炎##喉炎##喉梗阻
右背部转移	躯干继发恶性肿瘤##转移性肿瘤
食管胸中段鳞癌（cT3N2-3)	食管胸中段恶性肿瘤##鳞状细胞癌
